text_script	multimodal_emotion
그럼 혹시 오늘 호박죽 얘기하려고?	6
아니, 내가 뭐라고 했어? 그냥 난.. 헤어졌다고 울고 불고 하는 오빠 모습이 여전히 내 눈앞에 선해서 그렇지.	0
응 그 희철이. 너가 아는 사람이니까 내가 이야기 했지.	7
성실하고 논문도 훌륭하게 잘 마쳤고. 아마 잘 봐 줄 거야.	7
 그래? 깍두기 담아놨는데.	7
누구 편은 임마. 넌 왜 그렇게 날로 먹을려고 하냐?	6
모르지.	2
네… 먹었어요…	1
뭔데 그래 얼른 말해봐.	0
유민이네 집이니까 조금 천천히 가도 되는데.. 바로 옆 동이잖아요.	1
뭐야? 너 고양이한테 생선 맡기다 몰라?	3
그러믄, 당연하지. 우리 아들이 가서 전교 회장 된다고 그러는데 싫다는 부모도 있냐?	7
그래.	4
아 정말요? 저도 반갑네요.  물건 보실래요?	5
네. 안 그래도 방금 갖다놓고 왔는데.	7
귀신은 무슨... 귀신이 세상에 어딨니?	3
샴푸하는 거? 뭐가 달라요? 그냥 벅벅 감으면 되는 거 아닌가?	5
그럼 어떡하지....	2
영수씨..!  네 그냥 2부만 올려 놓으세요	0
지금 내 옷에 앉은 모기 쳐 죽인거야?	6
나한테 죄송 할 일은 아니고.	3
응. 나 진짜 다 해줄 수 있어.	1
 네. 그럼 제가 좀 봐드리도록 하겠습니다.	7
아이, 무슨 소리야. 뭐가 소중하지가 않아. 소중한데.	6
니가 말을 그렇게 하잖아.	3
아니고… 안내음에 닭 울음 소리가…	6
만 이천원.	7
그러게. 형님 뵈러 다녀온거지? 차로 여섯 시간은 걸렸겠다.	1
네. 저번엔 있었는데, 오늘은 없어서요. 어디로 갔어요?	2
가 봐야 알 것 같거든. 수술을 하시는데… 위독하시다고 그러네.	4
아저씨… 죄송합니다. 제가 큰 죄를 지었습니다.	4
"아빠 유전자가 너무 강한 걸 어떡해..	 괜찮아. 나도 내 딸한테 미안할 지 모르니까."	5
내가 무슨 말을 어떻게 했다고 얘가 또 이렇게 난리야? 어디 무서워서 너한테 무슨 말을 하겠어?	3
형은… 지금 내가 사슴벌레를 새 먹이로 준 게 잘못됐다는 거야?	1
헐.  알았어. 대신 손빨래 해서 돌려줘야돼.	5
이천??? 그게 어디야.	0
또 어디가냐?	3
저 그럼 자리 비켜 주시겠어요?	0
그니까. 예약도 겨우 했다니까	6
 아 네~ 알겠어요. 그러면 제가 해드릴게요. 잠시만요.	7
피지컬이 안되면 그냥 바둑이나 장기를 두세요 그럼.	3
너 철봉 해봤어?	1
... 이모도 싫어?	1
그치? 사람들이 자꾸 내 어깨 너머를 쳐다보니까, 나도 막 궁금하잖아. 내 어깨 뒤로 누가 있는건지.	2
아니..	5
하…. 안 그래도 빡치는데 짜증나게 하지말고 내 방에서 나가라.	0
점점 더워져요.	6
 네. 꽤 잘 만들어요.	7
음… 첫번째 본 집이 마음에 들긴 했거든요.	2
첫째하고 터울이 너무 많이 지면 안 되는 겨. 생각해봐야지.	1
무슨 말인데 너답지 않게 그렇게 분위기를 잡아? 철 들었냐?	3
네, 그 때 상어도 보고 해마도 봤어요. 할머니. 해마는 사람 뇌에도 해마가 있어요.	1
그러게. 그럼, 무서운 얘기나 할까?        대나무숲 하면 무서운 얘긴데.	2
다들 엄마들이 오는데, 할머니가 오면 어떡해요.	4
그렇게 말하면 나는 서운해.	4
한국인은 역시 쏘주지.	7
자꾸 이렇게 떼 쓰면, 망태기 할아버지가 잡아간다?	2
귀 찢어지겠어! 조용히 좀 해!	6
나? 나 담배 피우냐고? 아니야!	0
잘 설득해야죠.	2
그치? 아. 이모 너무 힘들다.	7
그래? 엄마 핸드폰 번호는 알아? 너 이 동네 살아?	1
응. 좋았겠다. 근데 우리집은 텐트도 없고, 캠핑을 어떻게 가지?	6
응. 에어컨 밑에 있는게 최고야.	1
에이씨, 내가 이 나이 먹고 어리광 부릴 수 있는 사람이 할머니밖에 없잖아~	7
이직 생각이야 옛날부터 있었지. 진짜.. 너무 힘들었어.	6
알았다. 이 할미가 엄마한테 단단히 얘기하마.	7
그치... 너무 조금 살면 허무하지.	1
죄송해요. 최근에 야근도 많고, 태국 출장도 다녀와서….	2
아 네 알겠습니다.	3
좋아하는 여자분이 생기셨는데 왜 이 천만원이나 필요하세요?	3
그래. 알았어.	4
아뇨 안 나타나죠 근데 보통 누가 4등 되고 로또 됐다고 해요	6
죄송해요.. 제가 인기가 없어서	4
응. 아니, 근데… 에이, 됐다.	3
그걸 어떻게 버려? 내가 얼마나 잘 끼고 다니는데.	0
응! 진짜 기억 하나도 안 났는데, 그걸 니가 다시 끄집어냈네?	7
내가 왜! 나는 그 게임 한번도 안 해봤어!	6
야 임마. 학원에서 너 등록안했다고 전화오는데, 그거 안 들킬 것 같았냐?	3
 히히, 그러면 7월 1일 일기부터!	7
 하….	6
 엄마가 언제. 아 진짜 무슨 일인데.	5
제가 어떻게 하면 될까요? 무슨 방법이 없을까요?	2
"에휴. 형님이 애를 오냐오냐 키워서 그런거 아니야. 	어렸을 때부터 그냥 니가 원하는 거 해라 그러고."	3
근데 책은 왜?	1
족발 맛 나는 보쌈 같은 맛이야.	7
 이걸 어쩜 좋아.   니 형이 아직도 저 세상을 못 가고, 우리 주위를 떠돌고 있나보다.	4
네덜란드? 좋지. 근데 네덜란드로 특별히 쓰는 이유가 있어?	5
또 샀어? 그정도 안됐으면 안되는거야.	3
그러게. 뭐야?	5
진짜 나는 이제 사람을 믿을 수가 없다	3
그러니까. 들고 일어나야지, 가만히 있으면 봉으로 본다니까.	0
아. 근데 주소를 모르는데..	2
진짜야. 더럽게 못생겼더라고. 그 선배, 나 싫어하봐.	5
아아 스트레스!!!	0
남았지.	1
아.. 네. 기억하시네요.	5
근데 엄마는 진짜 서울이 얼마나 무서운 줄 모르는 구나.	1
다른 친구들이랑도 헤어지기 싫은데...	4
네…	2
엄마 봐봐.	3
나 어제 한 잠도 못 잤어.	4
체대는 실기시험 봐요. 체육으로 하는거요.	1
약이야. 먹어도 돼.	1
세종대왕이랑, 이순신이랑, 광개토대왕이랑 있는데	2
거기 어디냐… 교회 앞에 까페.	3
그러니까. 여기가 교통도 좋고, 3층이라 채광도 좋고. 살기엔 아주 좋아. 여기 살던 학생도 계속 여기 살고 싶어했는데 이번에 공무원 시험 합격했다고, 어쩔 수 없이 가는 거야.	7
" 내... 내가?	 내가 매니저를 제대로 해낼 수 있을까?	 너한테 폐가 되면 어떡해."	7
아니요.. 잘 모르겠습니다..	6
엄마 어떻게 그럴 수가 있어? 나한테 어떻게 그럴 수가 있어?	4
니가 언제 물어 봤었냐?	7
아, 나도 봤어. 요즘은 노점에서 생선 파는 거 거의 못 봤는데 신기하더라.	5
"어차피 제가 반대하거나 말거나	  결혼, 할 거 아니에요?"	6
그럼 현관 비밀번호는?	2
진짜로… 내가 이번엔 제대로 할게. 내 명예가 있잖아. 잘못 만회할 기회를 줘.	5
다른 애들은 다 돌고래반까지 올라갔는데, 나 혼자 못 올라갔어.	4
 네. 벌써 두 달 넘었지요.	2
어허. 다른 애들은 잘만 하는데, 왜 이렇게 투정을 부릴까.	7
아닙니다… 어떻게 이런 일이 생겼는지…	4
아니야. 그냥 서랍처럼 문 여는 김치냉장고도 있어.	3
유에프오를 사랑하는 모임의 약자야.	7
엄마 나 꿈이 생겼어.	7
제가 뭘 했다고, 경찰을 불러요?	3
오우. 새별님. 실제로 보니까 진짜 아름다우세요. 올해 나이가?	7
그래 미안해 해야지.	0
하여튼 엄마가 너무 오냐오냐했어.	0
어 근데, 오늘 나도 엄마한테 전화한다고 갖고 오고 혜지도 아까 엄마랑 통화한다고 갖고 와서 너까지 그러면 쌤이 좀 의심할 수도 있어.	2
일본이 온천이 그렇게 좋다더구먼.	5
그래! 볼트가 쌌으면, 너가 다 책임져야지.	3
바바리맨들은 무슨 전통이 있는거니, 왜 꼭 옷도 그렇게 똑같이 입어.	3
" 이야아 선견지명이 있네! 나 츄리닝 좀 빌려줘.	  본격적으로 달려보자."	7
너가 잘못한거는 생각 안 하냐?	3
노지 열무가 이제 성기어질 때라 그래.	1
아니고, 그 웹 드라마 제작하는 업체.	1
그래? 근데 다른 할머니들한테서도 할머니 냄새가 나.	5
아 그럼 문자로 계좌 넣어드릴게요.	7
음... 뭐 대체로 그렇지.	1
애? 글쎄…. 그럼 시간이 좀 더 걸리겠네..	6
이 짐승만도 못한 자식.	0
언니 만나기 싫다고, 꼴도 보기 싫다고, 지금 나 보낸거잖아.	0
진짜야?	5
지은이는 아직 어려서 안 돼. 성인들만 볼 수 있게 만들어진 건 다 이유가 있는 거야.	4
그러지 말고 같이 가자. 필요한 건 내가 다 준비 할 테니까.	1
저 때 피부도 탱탱하고 머리숱도 많고. 가만히 있어도 예쁜데. 다 망치네 다 망쳐.	3
아니… 3등도 잘 한 거지. 근데 아빠는 1등밖에 안 해봤거든.	3
얼레레? 갑자기?	7
아 별거가 아니라니!	0
응 진짜로. 진짜 꼭 가봐.        우리 그럼, 그냥 주말에 한 번 가볼까?	7
어유 이 정도인줄은 몰랐네.         나는 소 한 마리 있으면 손주놈 대학은 보낼 줄 알았더니만.	6
뭐가 이상해. 그냥 너 평소 하는 것처럼 들이대.	7
불륜녀랑 거의 뭐 살림을 차렸던데? 어엄청 행복해 보이더라.	3
아니, 밥도 그대로 있구만. 뭘 드신다는 거야.	6
바람 소리 같기도 하고, 나무가 서로 스치며 흔들리는 소리 같기도 하고…	2
별 일이 왜 없어요. 선배 빠지니까 완전히 난리가 났지.	6
"내가 그만큼 해서 우리가 이 정도 표현하고 사는 거우.	 나는 우리 딸들이 엉겨 붙으면 좋기만 하드만."	7
그럼 예약? 같은 게 될까요?	4
아들은 만나는 여자 없어?	1
조금만 참아. 고 3이잖아. 니가 좀 참아. 원래 고 3들은 다 까탈스러워.	1
그래.	6
아 형님. 그런 건 형수님한테 얘기하면 바로 아웃이죠. 그냥 형님 선에서 넣어봐요.	6
정신 똑바로 차려. 당신 자식도 마찬가지야. 반성은... 그 놈 감옥 들어가서나 하라고 해!	0
나 부모님한테는 뭐라고 얘기하냐? 그리고 이제 앞으로 어떻게 하냐?	6
왜 그렇게 생각해. 솔직히 그 자식 맨날 바람피고, 언니 데려다가 예비시댁이다 뭐다 일만 시키고.	3
 음음 그죠.	5
" 아 뭐야. 무서워!!	 나 갈래!!! "	6
신? 그게 무슨 말이야?	2
 야 너가 괘씸하다. 너가 괘씸해.	3
너 그거 기억해? 그때 우리 지하 소극장 하나 빌려가지고 공연 했었잖아.	1
"알았어 미안해. 	빌려줄게."	6
부장님은 여기가 집이고 거기가 직장이래요.	3
아니 내 마누라 요새 바쁜지 물어보지도 못해?	6
그렇다고 봐야 하지 않아요? 손님들이 바글바글해야 성공한 장사꾼인데… 아빠는 사람들이 바글바글하면 싫을 거 아니야.	2
어이고, 모자가 아주 성질머리 하고는. 그러니까 그런 흉악한 일에 휘말렸지.	0
걔도 차있거든? 외제차. 그거 가져오라고 할까?	5
응. 미미 참치캔 같은 거 이제 먹을 수 있나?	1
그 강아지… 유기당한 거겠지?	4
어...아.. 내가 좀 취한 거 같긴 하다.	6
어떻게 견제하는데?	5
그게 아저씨 일이에요?	6
그건 엄마 생각이고!         지난 번에도 옷장에 청국장 냄새 안 빠져서, 옷 다 새로 빨았잖아!	0
일 안 한지 5년 됐지?	4
아이고. 요즘애들은 다들 왜 저러고 다닌다냐.         학생 때는 학생답게 하고 다니는 게 제일 예쁜건데.	3
그래. 내가 가봐야겠다.	7
잘 때마다 머리 땋여 봤어? 온 몸이 스케치북 되는 데 괜찮겠어?	6
네. 감사합니다.	7
그러면 빚은 어떡할건데? 누가 갚아줄건데?	6
………..고마워.	3
혹시 범죄 영화는 없나요?	3
응… 오늘 집 앞에 찾아왔길래 무슨 일인가 했더니… 헤어지재	4
넌 형한테 혁수가 뭐니.	0
형님... 다른 거라면 시키는 대로 다 할 게요... 제발요......	4
 아 술 냄새.	6
아니 나, 요즘 기침이 자꾸 나가지고.	6
오빠가 잘도 도와주겠다. 한번만 맛집 같이 가달라고 사정, 사정을 해도 들은 체도 안 하는 데.	3
네	6
나… 혼자 잖아.	1
아니 왜 들어보지도 않고 화부터 내는데!	0
"초등학교가 얼른 끝났으면 좋겠다고? 	너 아직 4년도 넘게 남았어. 큰일났다."	2
내가 제사 가져가잖냐.	6
아니? 딱히 그런 건 없는데.	2
에휴… 그것도 다 어른들이 하는 괜한 소리죠.. 어리다고 다 행복해요? 참나…	0
그래도 환갑인데, 밥만 먹는다고?	1
딱 백 원 차이여서… 크게 차이 안 날 줄 알았지. 이렇게 돈 많이 들 줄 몰랐어. 그리고, 나 지금 이만 원 밖에 없어.	4
개가 날 걸 좋아해.	1
선배님.. 제가 어제 말씀해주신 발주처 계약서 문서를 공유 드라이브에서 찾아봤는데요…	2
내가 찔렀지~	3
그래도 니가 너무 군대갔다온 사람처럼 군대 얘기만 하면 애들이 당연히 싫어하는 거 알지?	3
어. 솔직히… 형은 중 1만 되어도 이길 듯.	1
"싫다니까요!!!	 안 갈거야! 할아버지 혼자 가!	 싫어!!"	2
어머, 제가 그런가요?	3
무슨 생각?	5
바쁘신데 먼저 들어가서 정말 죄송합니다. 과장님은 퇴근 안하세요?	5
치. 맨날 못생겼다 그러면서.	6
얘기 안 했는데요??? 무슨 일이야 이게.  여보! 나와봐 좀!!	5
알겠어요.	4
응 알지. 뉴스에서 봤어.	7
누가 버렸는지 모르면, 제가 버린 사람이 되는 건가요? 웃기는 아줌마네.	3
 그럼 드리지 말던가.	7
"네. 같은반 친구에요. 	 둘이 좋아 죽어요. 종일 붙어 있어요.	 얼굴 다치게 한 것도 서연이 그림 그려준다고 사인펜 뚜껑 열다가 그랬어요."	7
아 아빠 알았으니까 잠깐 나가서 기다려	3
알았어. 갑자기 무슨 일이라니.	4
그렇구나. 고마워. 또 생각나는 거 있니?	7
 어떻게 그렇게 잘 알아?	7
아.. 무슨 배우 때문에 이렇게 화를 내?	6
아닙니다. 죄송합니다.	4
어우 진짜? 야, 아들이 서른 넘어서 그러면 좀 징그러울 거 같은데?	5
콩나물?! 그럼 여기 말고, 슈퍼에 가야되겠다.	5
아... 제가 전세는 이번이 처음이야.	4
 3년째? 야. 삼촌은 6년 사귄 여자도 있었어. 쪼끄만 게 결혼은 무슨.	3
정말?	0
성경에도 나와요. 예수님이 물을 술로 바꿔주시잖아요.	1
나중에 가서 보면, 너 고3이라고 신경써 주는 사람들 잔뜩 있었던 시간이 그리울 때가 올거야. 지금은 다들 니 비위 맞춰 주느라 힘들잖아.	1
아무렴 그 사이 꽃이 시들었겠어?	3
속들이 원래 좋은 가보지. 난 아니야.	3
 방에 컴퓨터 켜놓고 나왔어.	2
" 아이, 형님. 제가 잘못 했어요. 네?	 다음엔 안 잊어버리고 사 올게요. 오늘은 조상님들께 전 없어서 죄송합니다~ 제가 사과 드릴게요. 화 푸세요 형님."	2
하긴... 아무도 안 읽어봤겠지?	7
너도 찔리는게 있어서 기분이 더러운 걸 거 아니야? 내심 커피 사마시는 거 과소비라는 사실… 인지하고 있는 거 아니야?	3
세계여행? 갑자기? 얼마나?	5
"당연히 서운하지! 원래 아빠만 사랑한다고, 	아빠랑 결혼하고 싶다고 노래를 노래를 불렀는데 	이렇게 쉽게 변해버리다니. 실망이다 너."	0
….이해해.	6
봤네 봤어~ 야 선생님 좀 그만 지켜봐~	7
어디 보자… 3번? 그게… 야… 야… 이거 왜 이렇게 어려워? 요즘 애들 문제 너무 어렵게 내고… 이게 다 교육과정이 문제라니까.	5
아빠 저 왔어요.	7
네… 오늘이 동생 생일이거든요…	4
응. 근데 나는 거의 못 봤어. 너무 무서워서.	2
서운하니까 그러지.	4
계좌 내역 보여줘 봐.	0
"하여간, 못된 거는 아주 순식간에 캐치하는구만. 	 너 그런 거 따라하지마!"	3
아니면, 곰국에 라면 끓여먹어도 되나?	7
혈압이 많이 높으시네요?	5
여기 목 뒤에!	5
마지막 선물이라고 생각해. 	4
새 집에 니 방은 있다니?	3
진짜요? 저 주시는 거에요?	7
사람 일은 모르는거다. 그런 애들이 더 나돌 수도 있어.        꼭 안 그렇게 생긴 애들이 뒷통수 친다니까?	6
그러면 무슨 재미야. 그리고, 알고 보면 그렇게 어려운 것도 아니라고.	3
뭐? 갑자기 옛날 사람이라는 게 거기서 왜 나와. 그리고 임마. 아빠가 왜 옛날 사람이냐, 너랑 같이 살고 있는 동시대 사람이지.	0
"제가 공생하는 사이에서 예의를 지키려고 기자님 직접 찾아뵌거지 다음 번엔 기자님 얼굴 직접 안봬요. 정치부 오신지 얼마 안되셔서 아직 잘 모르시나본데	 어떤 게 기자님 인생에 도움이 될지 잘 한번 생각해보세요."	3
 여~ 좋은 아침.	7
뭐? 야 엄마는 아직 한창 때야. 갱년기는 무슨.	5
왜 그러지?	1
코너 캔디 샤 -샤샤 예-예.	1
그러게 말이다. 그렇게 그냥 잊혀진 사람이 됐지.        그 여학생은 어디서 뭘 하고 있을까.	4
정말요?	5
그렇구나	4
저 지금 벌써 약속에 30분 늦어서요.	2
무슨 일이 없는 게 문제지. 요즘 애들 방학과제 해주느라 잠을 못자. 방학과제 그거 진짜 나쁜거야.	6
 지금 뭐라고 하셨어요…?! 아빠라는 작자가 술을 그렇게 마신게… 우리 엄마 때문이라구요!?	0
그냥, 그냥 그렇게 해주세요.	1
네?	5
 왜요.	6
그러니까. 언니가 그 때 엄청 힘들거라 그랬잖아. 근데 나는 그게 뭔 말인지 머리로는 이해했는데 진짜로 이해하진 못 했거든? 근데 첫 날에 엄마랑 대판 싸우고 나서 완전 이해했잖아.	6
엄마, 나 다시 집에 들어올까?	4
네? 뭐라구요?	5
아.. 내가 왜 사과를 해?	3
아니요, 저는 주제를 6.25 전쟁 시기로 잡았는데,  할아버지 혹시 그때 몇살이셨어요?	2
알았어. 알았어. 당장 사줄게.	2
원래 주는게 어딨어, 원래. 나는 뭐 땅 파서 고춧가루 샀어? 다 돈 주고 사는 거야. 오 년을 그렇게 해줬으면 감사한줄 알고, 알아서들 좀 해야지. 에휴! 내가 자식새끼들을 다 잘 못 키웠지.	3
내가 언제?	5
네.	1
나이야 뭐, 두 사람이 한 살 차이니까. 그래도, 네 오빠가 사람이 진중한 맛이 있잖니.	1
나 저번에 미팅한 애의 친구의 친구.	1
안 하면 더 좋겠지만… 일단. 알겠습니다.	0
정말? 그런 프로그램이 있어?	5
근데, 배고픈 거 같아서 우유병을 물리려고 해도 싫다고 다 집어 던져버리던데요?	2
괜찮아. 할머니, 좋은 곳으로 가셨을 거야.        김씨 할머니, 평소에 기부도 많이 하고, 좋은 분이니까.       천국 갔을거야.	2
당연히 봤지. 너희 누나랑 나랑 만난 시간이 얼만데.	3
다음부터는 출고 하기 전에 꼭 먼저 전화 해보고. 잊어버리면 안돼.	0
경찰 아저씨라고 해! 그냥 아저씨 말고! 경 찰 아 저 씨 !	0
응. 이제 미국 갔다오면 대학 강사 같은 것도 뛰고 할 수 있으니까. 좋지.	7
드레스가 그렇게 비싸다구요?	5
선희씨도 그렇게 생각하시죠?	5
그럼. 말하지. 우린 부부잖아.	6
 그 놈의 고추 다 뽑아버리던지 해야지 진짜.  의사 선생님이 밭에 나가지 마시라고 했잖아요.	0
아 엄마 언제 와? 엄마 맨날 늦어	4
양심 좀 있어봐라. 좀.	0
어제 엄마랑 무서운 영화 봤단 말이야.	2
너, 말하고 싶은거 있구나? 할머니한테 털어놔봐.        엄마는 어차피 이해도 못해줄텐데.	6
진짜요? 그런 약이 있어요?	5
"근데 남자친구는 결혼하고 싶다고 그러면 	헤어지는 게 맞지."	6
"잔말 말고, 엄마가 지금 영어학원도 알아보고 있으니까,	 너네 친구들 좋다는 데 있으면,  엄마한테 바로 말해. 알았어?"	6
그래. 새벽에 연락이 왔어.	4
그건 그러네... 그럼 그냥 아빠랑도 살고, 저랑도 살아요.	6
그니까 완전 뒷북인데. 갑자기 보게 됐어.	7
형이 얘기 안 했어요?	5
어? 삼촌 안녕하세요.	5
아니야. 그렇게 안 매워.	1
좋아. 당장 내 번호부터 삭제해.	0
우리가 몇 년지기 친구야… 자그마치 십년이잖아, 십년. 그 동안 내가 옆에서 너를 얼마나 많이 도와줬는데… 나도 갑자기 가세가 이렇게 기울지만 않았어도, 너에게 이런 부탁은 하지 않았을 거야.	4
내가 뭐 연락 하기 싫어서 안 하니? 그렇게 아쉬우면 니가 좀 연락을 하지 그랬냐.	3
 불고기~	7
그러게나 말이다. 나는 우두커니 빈 집만 지키고 있어. 꼭 개가 된 거 같아.	3
그래요? 몇 번 짰는지 헷갈려서 그런지…	4
그럼 맞팔이, 서로 쫓아가는 거냐?	6
저기 가게들 박스 내놓을 시간이니까, 가서 좀 주워 와.	6
아니, 우리 아내 아는 사람 딸이 엄청 착실하고 예쁘다 그래서.         내가 딱 박주임 생각이 났지.	7
아예 작정을 하고 나왔더라고. 나간 내가 모지리지.	4
아 또 옛날 얘기해. 아빠 옛날 사람이야.	0
자네 요새 일하는 건 어때?	1
어째서지?	5
진짜?	5
딱 십오일씩 떨어져 있는게 아니라, 때에 따라 십일 십 오일 이십일 이렇게 다르기도 한거야.	1
아.. 전 괜찮은데...	6
걔랑 헤어졌어.	4
나도 걔가 너무 불쌍해 보여서 한번은 먼저 말을 걸어 보려고 했는데...	4
음... 그렇구나…	7
어? 기억 하나? 그 때 왜, 할머니 생신 잔치 때 왔던 어린애 있잖아.	5
네….	1
아니. 펜 신경 쓰는 것처럼 성적을 좀 신경 써봐라.	0
야, 나 잠깐 카드 내역 생각해 보고 줄테니까 기다려..	1
그럼 좋은거야?	1
아 아빠 그만 하라니까.. 나 정말 무서워 진짜로..	2
형 혹시 경비 얼마나 들었는지 하고 정보 좀 알 수 있을까요?	1
당연하지. 요즘 나이는 옛날처럼 계산하면 안돼.	1
일 처리를 그렇게 하면서 장사를 어떻게 하냐... 참나..	3
아… 진짜. 알았어.	6
나? 아빠 닮았지.	1
니가 먹었나보지! 몽유병처럼 자다가 나와서 먹었나보지!!	0
다른 애들이 왜 너를 모함해.	0
니가 잘못을 하니까 그렇지!	0
저도 초대해주세요. 술 사들고 놀러 가겠습니다.	7
갑자기 뭔 소리야. 니가 여자도 아니고 성형수술을 왜 해?	7
많아~ 진짜 많아. 니가 몰라서 그래.	1
아니지. 그런 건 아니지만… 근데 여기 불고기 내 생각보다 맛있다.	2
어… 누가요?	5
뭐 삼십대?	0
우와, 멋있어요.	7
왜 협박하는데! 할머니한테 다 이를거야.	4
언니가 나이가 들어서 그렇지 뭐.	6
미치겠다 진짜…	7
"아, 나 이제 힘들어. 	 내일 바이어들 온다는 데, 일찍 자야지."	0
좋은 것도 내 맘대로 못 해요. 정해지면 그냥 좋아야되는 거지.	4
희수야… 에휴, 좀 얌전히 자라 주면 안되겠니? 너 중학교 가면 이제 맨날 치마 입고 다녀야 하는데 그 머리가 어울린다고 생각해?	3
또? 이번에 다섯 번째 아니야?	4
이사 나간 지가 언젠데, 이제야 짐 정리를 해.	0
네.	4
네 그냥 저는 학교 다니고 있죠.	7
"아니, 요즘 애들은 어디서 신부도 잘도 얻어서, 결혼도 잘하드만.	 그 뭐야, 신혼부부 전세 대출? 그런거 받아서 집도 턱턱 마련하고. 	 너는 뭐 만나는 사람도 없니?"	3
응?	3
오늘 안 들어가면 안돼?	6
알았어. 그럼 어떻게 하면 좋을지 엄마랑 같이 고민해보자.	6
밤에 뭐가 재밌어?	5
내가 왜?	5
시골 가면 뭐 해보고 싶어?	7
정기모임이 이번달에 며칠이지?	5
"아 뭔데 이리 호들갑이야.	 정신 사나워 죽겠네."	6
나 진짜 아니라니까!? 할머니가 말한거 아니야?	0
아니 그럼 고등학생은 노래방도 못 가?	6
네 그럼요. 책상 앞에서 오래 앉아 있으면 힘든 거랑 마찬가지에요..	1
휴.. 봐봐 할머니. 일단 사진을 찍었잖아. 그럼 여기 앨범으로 들어오지?	7
 나 나갔다 온다. 	2
음.. 제가 동생을 처음 때렸던 순간입니다.       동생이 이제 막 걸음마를 떼던 때였는데, 저는 그 때 당시에       동생이 너무 미웠어요. 엄마도 아빠도 동생만 신경썼거든요.       그래서 동생이 일어서지 못하게 자꾸 동생을 밀어서 넘어뜨렸어요.      그런데 동생은 울지도 않고, 계속 일어나더라고요.      그게 너무 미워서 동생을 때렸어요.       그러자 동생이 무시무시하게 큰 소리로 울었어요.       마치… 자기도 여기 있다고, 누군가한테 말하는 것 같았어요.	4
아 그럼 우리 좀 주라.	7
 하… 엄마도 충분히 충격적인 고백이었으니까.       절대 나한테 화내기 없기다?	4
아. 이게 참… 그냥 혹시나 해서 여쭤보는 건데요. 어제… 아이 때리셨나요?	2
아니. 그러니까 시험 끝난 날 부터 성적표 나오는 날까지가 제일 좋은거야	7
너 왜 카페에서 혼자 이러고 있어?	2
그게 뭐야.	7
왜 남의 물건에 막 손대고 그러세요?	5
다 고치해줄거야? 나… 이런거 처음 해봐서 좀 긴장돼.	1
난 내 딸이 요리를 한다는 것 만으로도 장하다.	7
지금은 다른 동네로 이사갔는데, 구평동에 미친 치과의사가 있었대.	2
언니도 반바지 입고 놀았잖아.	0
네… 그런데 제 생일이랑, 주소… 발급일자는 그대로 다 나와 있어서…	2
네… 그래도 1-2백 하나봐요.	2
세준이? 그래 아줌마랑 같이 사무실 가자.	7
자네, 그 경비로 일하고 있는 아파트 있잖아.	1
기생? 너 진짜 인간이 못됐다. 그렇게 말해야 겠냐?	5
 제가 손주 볼 나이에 이게 지금 무슨              일인지 모르겠어요. 임신 확실해요?	2
알았어….	6
징계위원회에서 처리하고.. 걔들 퇴학시키거나 강제전학 보낸대.	1
죄송합니다. 다시 이런 일 없도록 하겠습니다.	2
설마…	3
죽어라고 일해서 맥이고, 키우고, 공부시켜 놨더니 허구한날 집구석에               틀어박혀서 너 대체 뭐하고 있는 거냐? 얘기 좀 해봐.               너 대체 요즘 뭐하는데?	0
당연히 되지요 아버님. 여기 몇 가지 정보만 작성해주시면은 20프로 세일을 해드리고 있어요.	7
할머니도 어릴 때 괴롭힘 당한 적 있어?	4
그거는 저도 못 보여드려요. 학교 규정이라.	6
맞아. 지금 이렇게 추억 만들어 놔야지.	1
근데 귀신은 우리가 모르는 사람이고, 조상님들은 우리 가족이니까.          귀신들은 한을 품고 우리한테 접근하는 거고,         조상님들은 우리를 보살펴 주려고 오시는거야.          그러니까 다른거지.	6
반에서 22등? 너 맨날 독서실 간다고 나가더니 공부안하고 뭐하고 다닌거야?	0
이선좌가 뭔데?	5
잘못했어요 형수님.	2
왜 그랬어. 나 진짜 피부 하얗고 키 큰 사람 좋아하는데.	6
네, 다 맞는데요… 그래도 저보다 한참이나 어린 분이.. 이런식으로 말씀하시는게 좀 듣기 힘드네요. 솔직히.	4
다른 사람들도 좋았는데,        이모부는 딱 첫 마디 나눴는데, 이 사람이랑 결혼하고 싶더라고.	5
하이고! 나였으면 열 번도 더 빌었다.	3
"아니, 건조대에 올려 놨으면, 먼지 안 쌓이게 덮개를 덮어놔야지,	 그냥 공기 중에 헤벌레, 펼쳐 놓으면 되겠어 그게?"	0
조금만 버텨보자.	4
 저 무시하세요?	0
그니까. 지는 골프치면서 선크림도 안발랐는지 주름이 아주 자글자글 해. 나 무슨 50대인 줄 알았다니까?	6
그래. 나도 화장실 좀 갔다 와야겠다.	1
저도 경험이 있으니까.. 대충 짐작은 했는데, 이렇게 빨리 사단이 날 줄은 몰랐네요..	4
네. 그런데, 아직 계약하겠다 싶은 사람은 없네요.	2
환자들도 그게 이해가 안되는 거지.	2
엄마는 좀 어때? 좀 나아졌어?	4
그래. 그래서 그냥 애인이 생겼다고 했어.	4
그걸 지율이라고 하는 거에요?	5
너 이거 진짜 꿀팁이야. 메모해놔. 말하면서 괜히 영어 많이 쓰는 남자들 있지? 그 인간들 다 지뢰야. 조심해야 돼.	1
응. 엄청 엄청 나쁜 생각해. 나.	1
 음… 시리얼 먹을래!	7
어머. 어딘데요?	4
집? 아직 구체적으로는 얘기 안 해봤는데,  내가 모아놓은 걸로 대출 받아서 잡으면 되지 않을까?  요즘 신혼부부한테 혜택 많이 준다던데.	1
응. 엄마가 9시 되면 자라고 불을 꺼줘.	1
너, 돈은 돈대로 받아먹고.. 일은 안 한다고, 내가 옆 자리 사람들한테  많이 들었어.	3
아 왜. 내가 알아서 할게.	6
아~ 왜~ 나 이모한테 계속 어린애 할래~ 나 좀 봐 주라~	7
알았어. 잔소리 좀 그만 해.	4
왜 그래?	5
뭐야. 그럼 엄마 폰이네.	3
어디 가세요?	5
"궁금하면 삼촌이 보든가. 	손이 없어 발이 없어?"	6
최용일입니다.	2
오랜만에 만나서 이상한 얘기나 해서 미안해. 괜히 너까지 우울해지게만 하고.	4
어쩔 수 없죠. 블랙이가 잘 지냈으면 좋겠어요.	2
윤성이한테 들었어.	1
네 알겠습니다. 다음부터는 이런 일 없도록 할게요. 한번만 봐주세요 사장님.	2
슈퍼 건강하다, 할머니. 근데, 꿈 꾸면 어떤 내용이야?	2
야 우리 어떡하냐. 증권사 다니는 친구가 이거 진짜 백퍼 오른다고 했는데.   오늘 꼭 사라고 했어.	4
아 귀찮아.	6
그건 당연한 거 아닙니까? 일 다 끝나고! 소 잃고 외양간 고치는 거 아니에요?	0
택수 아저씨네도 전자레인지 있지 않을까?	1
저도 뭐 들은 게 없어요. 삼촌이랑 똑같아요.	4
 형들이랑 나는 다르지...  나는 경력도 없고...	4
"너 요즘 사춘긴가 뭔가, 그거 온 거야? 	 왜 이렇게 엄마 속을 썩여."	2
많이 잤어! 지금 일어나야 밥 먹고 가지.	0
나! 너, 그렇게 안 가르쳤다! 체면 안 서게… 무슨, 무한 리필집이 말이 되니?	1
학교에서는 이런 저런 안 좋은 일들이 많이 일어나던데!	4
그게… 나 이번 학기부터 애인이랑 같이 살기로 했거든… 다른 친구들한테도 물어봐 줄게, 너 룸메이트 해줄 사람 있는지…	2
아….아 맞다! 돈스테이크!	5
그렇구나… 있잖아.	2
저 돈 없는데…. 꼭 굿을 해야 할까요?	2
그러니까. 너무 복숭아라, 조금 남사스럽게 느껴지더라.	7
그런가봐. 나도 못 알아 듣는 거 많아.	1
이모도요?	5
"니가 생각해도 징그럽지. 사회에 심각한 해를 끼치는 거라고. 	길가다 안구테러 당할 사람들을 생각해봐."	3
아 미안해. 좀 둬 내가 할게.	2
네.. 저도 후유증이 좀 있어요 조금만 무리해도 바로 다시 아프고..	4
네… 다른 일을 좀 하다가.	2
오늘 너 때문에 너네반 여자애 하나 울다가 조퇴했다며.	6
그럴 일은 없을거예요.. 제가 임상적으로 경험해 봤을 때는 그래요.. 일단 검사 데이터 같은 걸 또 자세히 확인을 해 봐야겠지만요. 암튼 화이팅..	2
어후. 고추 달린 놈들은 왤케 바람을 못펴서 안달이야?	6
근데 자꾸 생각 난단 말이야 궁금해서..	1
무슨 숙제?	3
고무장갑은 뭔데? 왜 고무장갑인데. 니 살림이나 하라 이거야?	5
흠… 프로게이머 힘들다던데…	4
삼촌, 나 피씨방 가게. 돈 좀 줘.	3
넌 나이가 몇인데 아직까지 반찬 투정이냐?	5
오…. 누나가 인정했단 말이지? 근데 그럼 오히려 아까워 하겠는데...	6
오늘 늦게까지 일한다고 했잖아. 이렇게 이른 시간에 왜 집에 먼저 와있어?	2
일단 5만원부터 줘봐.	6
이 동영상이 재밌다는 거지. 사람 우습게 보고 하는 말이겠니? 어머 황당해라. 날 그렇게 모르니 넌?	0
아 요즘 기침이 너무 심해져서요.	1
왜요?	5
…..네…	4
태국이 좋다더라고. 티비에도 많이 나오고.	4
돈은 잘 준대요?	2
어떡하긴 어떡해. 내가 그냥 해서, 먹고 살고 해야지.	4
그러니까요. 면접보러 올 때 느꼈던 거랑은 너무 분위기가 달라서 당황스러울 정도예요. 원래 있던 직원들이 텃세 부리는 건가 싶기도 하고.	6
장난이고. 요즘에 잘 보일 사람이 좀 있어서~	7
아. 돈이 좀 있으면 좋긴 한데, 그것도 뭐 꼭 필요한 건 아니에요.	1
뭘 한숨이야. 한숨 쉴 거 없어. 난 편하고 좋다니까.	6
너무 무서웠어…	2
응. 다 언니가 이렇게 만든거야.	1
그 아들이 다음 달에 결혼을 한다네?	4
근데… 좀 걸리는 부분이 있어요.	2
나 없으면 너 혼자 어떡하려고 그래.	2
"아버지, 그런 말씀 좀 하지 마시고요. 	 혼자 지내시기 적적하니까, 저희가,다른 어르신들이랑 같이 지내실 수 있는, 시설이라도 좀 알아볼게요."	4
네? 그게 무슨 말씀이세요?	5
형님, 저 뭐 하면 될까요?	5
아 다용도실에 빨래 거치대 있어요. 그냥 거실 아무데나 펼처 놓으시고 널으시면 돼요. 개는 건 제가 갤게요.	1
응. 보니까 여기에 진짜 할머니 할아버지들까지 다양한 사람들이 있더라. 아빠라고 못할 거 뭐있어?	7
그래. 고마워.	4
딸기는 누구야?	5
아니. 소설가. 나는 소설 보면서 상상하는게 제일 재밌더라.	7
 아, 이거. 아무 것도 아니야.	2
어제는 안 그랬잖아.	5
그런 말이 아니라….	2
우리도 고양이 키우면 안 돼?	6
뭐 때문에요?	5
음... 별로 없는데...?	4
장기 대회요?	5
세상에. 정말 이상한 사람 많아.	7
아니. 왼쪽에.	1
어. 너 내일 되면 진짜 바쁠 테니까, 오늘 불러서 뭐 좀 물어보려고.	7
아. 너랑 있을 때도 말이 별로 없구나. 나는 그냥 낯을 많이 가리는 줄.	5
그.. 철수 얘기 있잖아. 철수 취직 얘기…	2
조금만 참아. 눈 딱 감고 밥만 먹어.	4
그래도 그거라도 안 하면 취업이 더 안 될 거 아냐.	3
너 지금 남자친구 있지 않아?	5
영어학원 다니래.	4
엄마 금방 올거니까 잠깐만 그냥 있어.	6
곱해?	5
혜정인 매달 적금을 니 월급 만큼 부어.	3
응… 그럼 혜민이가 너무 억울하고 힘든 친구들 도와주고 그럴 수 있어? 혜민이도 힘들겠지만…	2
야. 다 유전자야. 노력해도 소용없어.	3
맞네? ...어떡하지?	2
엄마, 우리 저기 가서 발 좀 담글까?	7
"그래도 위험해요, 이 사람아. 	나는 우리 딸 통금이, 아직도 10시야. 	10시까지 들어오려면 9시에는 출발을 해야 되거든. 	근데 지금 몇 시야 대체."	2
 스토리는 내면의 변화.	1
 네. 형 귀찮으신 거 아니면 혹시 부탁좀 드려도 될까 하고요.	2
"뭔 소리야 그건 또. 생기면 생긴 거고, 아니면 아닌 거지.	 그렇고 또 아닌 건, 무슨 뜻이야 대체?"	5
죽집은 어딨지? 저기 올라가면 하나 있지 않나?	1
응. 근데 내가 말했다고 하면 안 돼. 알았지? 선생님 화내면 무섭단 말이야.	2
내가 최 대리에게 못 해준 게 너무 많은 거 같다. 좀 더 친절하게 대해 줬어야 했어. 밥도 자주 사 주고, 무슨 고민이 있는지 들어 주고... 그랬다면 이런 일이 일어나지 않았을텐데.	6
시험 끝나니까 좋으냐?	7
자동차 10년 타기 운동은... 이제 옛말이에요~	3
왜. 아빠는 왕이 되기 싫어?	5
요즘은 다 그렇게 하거든? 그것도 몰라?	3
오늘 중으로 인트라넷 등록하세요.	1
정말? 삼촌이 해결할 수 있어?	7
아... 저는 아들이 하나 있습니다.	5
그건 휴가갈 때 입는 옷이지.	5
 야. 수업 중에 지금 나간다고?	1
"저번에 아저씨 그냥 물에 밥 말아 드신다고 	엄마가 걱정하시던데요."	6
직관적이라… 직관적 알겠어.	7
너는 학생이니까 뭐. 한 10만원이면 되겠지.	1
아니야. 전공인 애들도 있었는데 니가 1등한거야.	7
"아, 여기서 어떤 버스 타야 갈 수 있을까요? 	큰 버스 타러 가야하는데 길을 잘 몰라서."	2
그래서, 무당이 됐어?	2
"그래. 그리고 막 술도 있지 않아?	 양주 종류?"	7
내가 봤을 땐 그런데. 그래서 조심하라고도 했는데,        귓등으로도 안 듣더라. 아주 세기의 사랑을 하고 계셔요.	3
아 네...	2
나 카메라를 하나를 사려고 하는데.. 추천 좀 해줄래?	1
아니 그 사고가 인터넷 뉴스에 속보로 떴더라구요.	7
야. 너 나 잊으면 안된다.	7
그동안은 그럴 가치도 못 느꼈는데… 더 이상 못 참겠네요!	0
집에 가만히 있으면 덥지도 않아.	6
"아니, 딱히 문제랄 건 아니고. 그걸 받아주는 집이 별로 없어서. 	선택지가 너무 없는데?"	6
아니? 목욕탕에 사람 그렇게 많을까?	5
배다른… 내 사랑…? 이름까지는 모르겠는데.	2
그런데 선생님이 나한테 일어나라고 그랬단 말이야.	0
어 어. 그래서. 못 생겼대?	6
여기? 할만해. 쉽지는 않지만. 뭐 쉬운 일이 어디있겠냐만은..	4
"아, 뭐에요. 무서워요...	 근데 할아버지가 왜 저한테 그러는 건데요?"	2
"근데 어떡해. 니가 오늘도 숙제 안 해와서 	오늘 지금 남아서 나머지 공부 하는거잖아."	6
그거 술이야 임마. 아이고. 아무거나 막 마시면 어떡해.	5
그게 뭐가 창피해!!	0
 가게 규정이라서요. 부탁드립니다.	2
봤지요...	4
대박. 우리 중에 제일 먼제 결혼하겠네.	5
음… 되게 의외네… 그래도 내가 하는 나쁜 생각에 비하면 아무 것도 아닐거야~	1
 나? 톡하는데?	7
아니, 아주머니도 충분히 정정해 보이시는데요?	0
잘 봐. 내가 택수 그리는 거 보여 줄게.	1
저 옆 동네 영화관에도 없어? 자리?	3
그렇구나. 나는 10시 넘어서 자는데.	1
지금 동생이 아파서 낑낑거리는데 누나가 되어가지고 비꼬는거야?	6
제가 뭘 잘못 했는데요?	3
너 학교 어디야? 부모님은 어디야?	0
이모~ 요즘 유행하는 영화 뭐 봤어?	7
아니에요..	2
지겹고 말게 뭐 있어. 먹고 살아야 되니까 하는 거지.	6
 아. 잘못했어요 선생님.  다음부터 열심히 해 올게요!	2
좋아.	7
세상에나… 진짜예요?	5
 집에 변변찮은게 없어서…이거라도 드셔요.	7
절하는 친구? 스님이란 말이야?	1
제가.. 엄청 어릴 때, 아무도 안 사는 집에서 자주 놀았는데요..	2
아…	2
너는 참견 좀 그만하고 집에나 가.	3
같이 늙어가는 처지? 당신은 애들 보기 부끄럽지도 않아?	6
영화에서나 봤던 게… 이렇게... 실제로도 있었네요….	5
지금 저희 잘못이란 얘기예요? 돈 벌기 싫으세요? 그쪽 물건 빼드려요?	0
십만원 짜리 태블릿 있으면 그거 사줄게.	1
아니요. 알지도 못하더라고요!	6
하고싶은 거 있다고 할 때 좋다고 응원해주는거는,        이십대 초반때까지 얘기구요. 너 예전에 승무원 하고 싶다고 해서        승무원학원 보내줬더니, 그 거 때려쳤지, 공무원 한다고 해서 노량진 보내줬더니,        거기서 같이 공부하는 남자애랑 눈 맞아서, 공부 하나도 안했지.        거기에다 그거 뭐야? 영어학원 때려쳐, 헬스는 가지도 않고.	0
정말…? 그 정도야…? 어… 이모 미안해.. 괜히 말 했나봐…	4
이게 내 한계인 거 같아... 형이랑 같이 있으면서 행복하면서도... 자꾸 안 좋은 생각만 들어.	4
경찰서가 제일 안전해. 거기서 엄마한테 전화도 하자.	7
나 봐라. 매일 먹어도, 날씬하잖아.	3
그런 억지가 어딨어. 너 내가 너 꼴보기 싫다고 때려도 그럼 정당방위라는거야?	0
아니야. 수민아. 공부 열심히 해서, 우리 대학교 와서  선후배 사이로 만나자.	1
근데 왜 안 보여줘. 선생님 보여 줘야 채점하지.	0
형준이가 공부해서 잘 본거면 짜증 안 나지.	6
짜장면 싫어? 그러면 치킨 시켜 먹을까?	7
절 한 번당 만원?	1
왜 못 찾아 그걸, 하이고. 잘 되어 가긴 해? 생전 안 하던 요리를 한다고 하고 그래.	3
응? 그냥.. 괜찮아. 왜? 너는 우리 엄마 좋아?	5
"잘 기억이 안 나요. 했던 것 같기는 한데, 	했어도, 워낙에 오래 전에 했어서, 잘 모르겠어요."	6
 맡아봐.	6
고기도 너무 얇고	6
그걸 어떻게 잊어버리냐. 그 날 엄마한테 혼날까봐 가방 싸들고 나왔던 거 기억난다.	6
나도 좋아하지.	1
마트꺼보다 괜찮아? 요즘 날이 더워서 신선도가 좀 떨어지지 않을까?	5
집 놔두고 카페에서 왠 공부?	5
아 몰라. 왜 그런걸 물어. 그런 말 잘 못해.	3
영수씨가 이게 회사 생활이 처음이라 잘 모르나 본데.. 그런 걸 보통 나같은 사람한테 물어보나..?	3
황금! 우리 황금 어딨어.	7
"만약에 그렇다하더라도, 예린이 탓은 아니야.	 혹시라도 그렇게 생각하지 마."	4
다행이다. 너희 엄마는 좀 작으시잖아.	7
그럼 칼을 빌려야지. 왜 가위를 빌려?	6
" 알았어! 차 빼면 되잖아!	  니 잔소리를 이렇게 맨날 듣고 있느니,	  그냥 몇 분 더 걸어다니고 말지. 	 "	6
그래. 개천에서 용난다는 것도 다 옛말이더라고. 내 동기들만 봐도, 진짜 다 재벌에다.. 잘 사는 부잣집 애들이야.	3
나, 나중에 웹툰 작가 할거야.	1
"누가 그냥 괜찮다고 연애를 해~	 좋아야- 하는 거지, 연애는."	6
그래도, 백 만원은 나올텐데.	3
넣어놨는데?	2
처자가 없단 소리는 안 허는 것이, 여자친구는 있나 보제?	5
그게 그 슬러쉬 같은 건가?	2
어유. 그래도 지난번보단 덜 올랐네.	2
자네야 워낙 예전부터 운동을 좋아했다지만, 그래도 좀 조심해.	1
내가 뭘 그렇게 잘 못했어! 다른데도 현금만 받는데가 얼마나 많은데!	0
근데, 내가 오늘 학과 회의 있는 날이라. 밖이었거든.	2
근데… 그렇게 소중하신 분들이 타고 다닐 차인데… 준중형 차로 괜찮으시겠어요?!	3
이번에 명문대에서 대학원생 하나가 투서 올린 거 뉴스에서 봤어?	1
"근데 혜미야, 너 생일 한참 남지 않았어? 	 10월달 아니었어?"	5
니가 그걸 왜 물어!	3
선생님은 뭘 몰라요. 전학가면 왕따 되는 거라고요. 왕따.	0
응, 엄마한테는 이미 이런 이야기들 다 했어. 전학수속만 밟으면 돼.	1
학원 이름이 뭐지?	3
아 축의금 또 얼마 내야 되지.	4
선생님 저 조퇴할래요...	4
내가 또 미래의 신부님께는 충성하지.  나랑 결혼해주겠다는데, 모셔가야지.	1
아.... 진짜 내가 너무 미안해 진짜.	4
시늉? 아휴 알았어 알았어	5
와. 진짜 부럽네요. 언제 저랑도 한번 같이 가시죠?	4
아니야. 엄마가 저번에, 나 자주 보러 온다고 했어.	4
그래. 나 한 번 말한건 꼭 지킨다. 알지?	7
그래. 그럼 나 다음에 형 차 한 번 타봐도 되나?	7
왜 한숨이야.	1
사장님… 저… 기억 하시나요?	2
그래도 돼?	1
야, 그런걸 누가 대신 얘기해!	3
네. 평수도 너무 넓구요.	2
예, 잠시만 기다리세요.	7
선생님이 무서운 얘기 해줄까?	7
근데 왜 부르셨어요?	1
 그럼 이거 먹지 마. 내 푼돈으로 산 거니까.	0
 와우. 죽이는데? 역시 외제차가 다르긴 다르네.	5
어? 내일이 그 날이야?	5
없다 왜. 아픈데만 골라서 찌르네 이자식이.	6
 그래! 뭔지 들어나 보자!	7
안돼. 경차는.	3
뭘 알아보고 있는데?	3
알아. 아는데… 다 결혼하고 나서 해도 되는 것들이잖아.	7
창피한게 아니야… 얼마 고통스러웠겠냐. 본인이. 응?	1
끓는점…? 내가 너만 보면 속이 부글부글, 절로 화가 나. 알았어?	0
네. 자꾸 야근하다 보니 자연스레 야식도 많이 먹게 되고, 운동을 하러 갈 시간도 없으니까... 한 달 만에 5kg나 쪄 버렸어요.	6
한 삼천 정도? 내리면 금방 나갈 것 같기도 해요.	2
못 살았지.	1
나도 일전에 이탈리아 여행 갔을 때, 믹스커피 가져가서 아주 잘 먹었어.	1
낭떠러지 같은 곳도 있었는데… 진짜 좋았어요. 아빠가 뒤에서 잡아줘서 멀리 내려다 봤는데.. 진짜 멋있었어요.	1
저...	2
뭐가?	5
네.	2
"몰라아. 	 언제 내 인생이 뭐 계획한대로 된 적 있어?	 팔자에 있으면 하겠지."	6
헐..스물 다섯 살인데 아직도 학교 다니고 있어?	5
다시는 안 갈려고.	6
주말에 아버님 모시고 절에 한 번 가야되지 않겠어?	2
내 친구니까. 이렇게 집이 더러운데, 친구가 좋아하겠어?	0
에이... 선배가 소개팅 해주면 선배 같은 남자 나오는거 아니에요?	3
그리고 여길 좀 치워야 되는데. 그날 실습한 조원들 다 불러서, 같이 좀 치우자.	0
 아~ 그거 너가 유지하는 거였어?	7
아저씨, 우리 엄마랑 결혼할 거에요?	2
 뭐….그런거지.	2
근데 담임 선생님이 인간은 언제나 내일을 생각하며 살아가야 된다고 그랬어.	6
전도사님 칫솔은 같이 쓰면 절대 안돼요.	3
그래. 너무 깊게 만나진 말고. 사람 일 어떻게 될지 모르니까.	6
저는 안 나는데. 아니면, 제가 방금 샤워하고 나와서 그런가.	6
 아 오빠아아아아. 한 번만 보여줘.       내가 이따가, 아이스크림 사올게.	7
그런가봐. 불쌍해 삼촌.	4
엄마가 쓰던 거 물려받았어요... 완전 오래된 거예요.	4
오늘 조기축구회 있긴 한데, 빼면 되죠.        김씨 아저씨가 저한테 참 잘해주셨는데..	4
모르겠어…	4
나 이 향수 좀 안 어울리지?	2
네.. 그래서 이걸 어떻게 극복해야 하나 고민이에요.	2
아니. 하루에 딱 세판 밖에 못해.	4
몰라! 나는 원래, 배고프면 기억이 안나. 우울해지고 그래.	0
그래.	1
그건 말하면 안돼. 꿈 사면 그때 말해 줄게.	3
아냐, 주부로 사는 나랑, 여전히 커리어우먼으로 잘 나가는 너랑 어떻게 똑같니?	4
아니. 그런 건 아니고…         너도 이제 다 컸으니까. 이해하지?	2
지금 멀쩡하지가 않으니까 이렇게 말씀 드리는 거 아녜요.	0
그게 그렇게 다른가?	7
네. 서울로 유학 왔어요.	7
네. 맡아놨잖아요. 그래서 책 두고 갔다온거잖아요.	3
아직 결과 안 나왔어요. 아마 한 이주 정도 있다가 결과 나올 것 같아요.	2
저는 진짜 그 주식이 잘 될 줄 알았어요. 진짜 확실한 정보라고 그래서… 금방 주식 오른다고 그랬단 말이에요.	2
에휴… 괜히 나 걱정할까봐 거짓말 했나보다.. 할머니는 아빠가 담배 끊었는줄 알았어.	3
치. 놀리지 마.	0
 만약에 나랑 떨어져서 지내야 된다고 하면은?	7
뭐?	5
그건… 올해는 안 빌었다?	2
저도 어쩔 수 없어요. 그러니까 내일까지 꼭 입금하세요.	4
왜요? 누가 돌아가시면 속상한 거 아니에요?	6
그 쪽 부모님은?	5
그래그래. 공부하느라 많이 바쁘지?	7
아휴 이 형님 또 흥분하셨네. 됐어요 저. 이제 그 회사, 회사에 별로 미련도 없고. 저 명퇴 당하면 형님 회사 들어가도 돼요?	6
헐 남자한테 빌려줬다고?	5
저도 다시는 그 쪽 뵐 일 없을 것 같네요.	3
운동하면 되지.	4
그래? 그럼 수학 시험 보기 전날에 파이널로 과외 수업 잡아 둘까?	1
 아 그러시구나 그럼 어떡하죠..	4
아니 형수님이 사과해야지. 어떻게 임신한 사람한테 그런 말을 해.	0
네 맞는데… 왜 그러세요?	5
그래서 공부도 잘 해야 되고, 운동도 잘 해야하는거야.	0
제가 뭘 어쨌다고 이러세요?	0
뭐.. 명절의 의미가 그런거긴 하지만.. 요즘들어 친척들끼리 자주 만나지도 못하고.. 괜히 마음이 쓰이네.	1
근데 지훈이 어떻게 했어! 엄마 말대로 했어?!	0
어머.. 그럼 뭐… 빚 때문에 그랬다는 거야?	2
이 천이요? 이 천 만원이나 대체 어디에 필요하세요?	2
그러면서 이렇게 무책임하게 사람 패고 다니라고 하면 어떡해.	6
이 그룹에서는 얘가 메인이 아니지. 싱어지. 혼자 무슨 랩퍼를 빨고 있어.	3
 됐어. 괜찮아.	3
응, 우리 지역구에 공천을 받았다더라고.	1
아 불안한데. 여기서 한 발자국도 움직이면 안돼? 엄마 갔다 올게. 모르는 사람이 말 걸면 대답하지 말고 알겠지? 누가 말 걸어도 대답 하면 안돼?	2
"응. 옛날에 동방명주 오빠들 매니저가 꿈이었어서 	 1종으로 따놨지."	7
그걸 벌써 다 썼다고??? 지난 주에 준 걸?	3
니가 빨빨거리고 돌아다니니까 그렇지. 가만히 앉아있으면 안 더워.	0
몰라... 말 시키지마...	4
"너, 지나간 것도 잘만 찾아서 보더만.	 이거 나중에 보고 ‘백년의 약속들’ 좀 틀어봐. 	 그건 지금 지나면 못 봐."	3
야, 꿈은 크면 클 수록 좋은 거야. 그건 너무 소박하잖아.	7
네?	5
나는 낳고 싶어.	2
그래도 손님…	2
그렇지만. 적어도 이런 일은 일어나면 안됐는데.	4
" 이게 뭐야?	 아무 것도 없는데?"	5
…그러긴 했는데, 다른애들 다 피시방 갔단 말이에요.	6
다른 건 하나도 손 안 댔어. 깡마른 화초 하나 있길래, 그거 내다놓은 거지.	2
그런건 누가 정하는거냐	6
그건 아니지만…	4
아 스테이크도 너무 질기고 말이야!	0
응, 그러려고 했는데, 아들놈이 이민을 간다고 하더라구.	4
소정이요? 그 얘긴 벌써 들었어요.	6
다연아, 왜 요즘 세준이 안 오니?	5
내가 다 봤는데 . 뭐, 전단지 붙이고 있었지?	0
나도 알아. 당신이 평소에 그렇게 생각 안하는 거. 나도 놀라서 좀 욱했나봐.	4
선생님도 너네가 걔 안 좋아하는 거 알아?	1
푸들?	5
아니 왜 그러는데... 지금까지 잘 참았잖아.	6
내가 그 친구 데리고 사업을 해볼까? 그 친구는 요즘 뭐한대?	2
약 먹으면 좋아지나요…?	2
아니라니깐요?	0
낚시 하려면, 체력이 좋아야 하지 않아?	7
"대답이 늦다? 	말 해. 얼마나 질렀어?"	2
어허.	3
네. 아유 우리 혜수가 웬 남자애들이랑 취하면 어쩌나 맨날 걱정이라니까요.	2
버는 돈이.. 뭐 우리는 상상할 수도 없는 정도인가봐.	1
그게 아니라… 에휴. 참. 학생 부모님은 어딨어요?	2
알았어… 그러면 딱 삼 초만 만져봐.  자.	1
"...음...선생님이 보민이에 대해 잘 몰라서 	 정확히 말하진 못하겠지만....	 그 정도로 힘든 일이 있었다면 예린이한테 얘기하지 않았을까?"	4
내가 와사비 왕창 넣었는데 뭘 맛있대.	6
너네 오빠가 너보다 훨씬 똑똑하지 않아? 학원.. 막 학원 현수막에 이름 제일 막 크게 써 있던데?	5
좀 의심스럽기는 한 이 주 된 거 같아.	2
무슨 하루 이틀도 아니고 공부하는데 맨날 시끄럽게 하니까 그렇지. 저 새끼 고 3때보자 내가 공부 못하게 난리 칠거야 맨날.	0
아… 네.	2
"아직 안 배웠구나. 그게 바로 완료형이라는 거야. 	 내 인생은 이미 결론이 났어. 	 희망이 그냥 gone~"	3
너한테 미래라는 게 있기나 할 것 같냐? 인간 쓰레기 같은 놈.	3
내가 재미가 없나?	3
그 때, 그 형이랑 우리 누나랑 크게 싸우고 헤어진 것 같던데.	4
 샘. 이거 지진이죠?	5
세찬이도 똑부러지지 않아? 남자애들은 원래 좀 느려. 이제 초등학굔데 뭐.	5
좀 입을 수도 있지? 아주 그냥 뻔뻔하네. 그래서 그거 어쨌는데?	0
그렇긴 하지… 에이. 참 이뻤는데. 시집와서 고생만 했다 니 엄마…	4
미소야. 언니 오늘 집에 오는 길에 희순이 만났어.	4
 너랑은 이런 것만 죽이 잘 맞아서 너무 좋아.	7
그래? 벌써부터 화장하면 나중에 피부가 다 상하는데. 슬기랑 혜지네 엄마도 아셔?	6
아니요. 그런 배가 아니에요.	3
너 진짜 왜 그래. 남자친구 사귀라더니, 맘이 바꼈어?	0
알았어. 말한다는게 아니라. 걱정돼서.	6
말도 안돼 진짜~ 나 진짜 괜찮아 할머니~	7
 거짓말이라뇨? 무슨 거짓말을 한다고 그러세요?	0
그래서, 부모님한테는 말씀 드렸고?	2
"그런가. 나 이거 하나 줘. 	 아, 카드 되지?"	7
 으아.	5
매운 치킨.	1
인공아파트 2차 상가에서 떡집 하신다는데, 너무 바빠서 학부모 모임에도 한 번도 못 나왔대.	4
아니. 그런 거 아니고요.	2
그건 그렇죠.  저희 혜수도 이제 고1인데.	6
안식년 아니고, 정년 퇴직.	7
그럼 그냥 친구들이랑 나눠 먹던가 아니면 좋아하는 선생님한테 드리던가.	7
맨날 야근하느라고 야식 먹고, 스트레스 받으니까 단 것 먹고. 좋은 거 먹고 찐 살이 아니라서 그런지 몸도 안 좋아지는 느낌이야.	2
다음달 모의고사도 걱정이에요. 평균 떨어지면 교장 선생님 또 뒤집어지실텐데.	2
 헐. 야 너가? 웬일이야.	5
무슨 일 있어?	4
앞 날 걱정이 왜 없어. 당장 오늘 방송에서 뭐 먹어야 좋을지도 고민이야.	3
미안해.. 근데 나 이번엔 진짜 진지해.. 나 정말 꼭 소설가가 되고 싶어..어릴적부터 소설가가 되고 싶었는데… 이제라도 도전해보려고해…	1
대관비를 지급 안해서... 예약이 취소가 되었대요.	2
현진이네 집에 자기랑 똑같은 물건이 막 여러 개가 있더래.         샤워가운이며, 블루투스 스피커며.	0
아 네.	5
 쯧쯧. 젊은 학생이 체력이 왜 그래.	0
이 놈 자식. 엄마가 괜히 한 번 그런 말 해 본 거지. 아빠가 무슨 허풍을 쳐. 자, 물어 봐, 모르는 게 뭔지.	0
제가 상황 한 번 볼게요.	2
아.. 일은 내가 알아서 할게. 얼른! 어휴  가 봐.	6
그러게… 아줌마도 충격이 엄청 크시더라..	4
너 그걸 농담이라고 한 거면 유머감각에 문제 있는 거야. 알아?	3
아니. 옷? 무슨 옷을 사.	5
안 그래도 부를거에요! 기다리세요!	0
나만 없어.	4
몰라. 한 20,30만원 할걸?	2
그 양반 성품이 아주 모난 데 없이 둥글고 착했지.	4
너? 너 애지…	3
할머니랑 30분만 하기로 약속했지? 지금 몇 시야?	0
아… 삼 대 시구나.	1
알았어. 근데 미영이 남편이 채식주의자라던데.. 어디 식당을 가야되나.	2
중학생이라고 일은 일대로 시켜놓고 알바비 제대로 안 주시는거에요?	0
뭐요? 며칠 전에 산건데 무슨 위약금을 냅니까?!	0
아 그렇구나… 제형이네 오빠가 불러내서, 자기가 찍힌거 풀어줬으니까, 걱정하지 말라고 했대. 그리고 욕도 하지말라고. 게임에서.	1
 이..이거 놓고 말하세요!	0
결혼기념일을?	5
부장님. 저 드릴 말씀이 있는데요.	2
아, 그거. 그 죄를 면해준다는 거 아니야?	7
외계 생명체가 니 인생에 그렇게 중요해?	3
자칫하면 저뿐만 아니라 세훈이한테도 불똥이 튈 테니까요.	2
저희 회사에 대해 들어 보셨는지요?	7
이강인! 아빠가 하지 말라고 했지! 아빠가 자꾸 똑같은 소리 계속 하게 만들래?	0
나도 하고 싶어서 하는 거 아니야. 안하면 안되니까 하는거라고…	3
그래. 올해 뭐 가지고 싶은 거 있어?	1
"아이 참. 알았다니까. 아빠 빨리 나가요.	 나 진짜 늦게 생겼어."	0
그런 적이 있어?	5
뭐 그렇지.	1
왜! 내가 가르쳐 줬잖아. 이대로만 그리면 돼.	5
차는… 달리는 로망이야.	1
하여튼 저 성질머리 하고는.	5
오늘처럼 무더위와 고온이 이어지는 날을 폭염이라고 그러는 거야.	1
나가라고!	0
그것도 괜찮네. 일단은 회사 일에 집중하고 천천히 생각해.	7
 이래서 늦는다. 저래서 늦는다. 요래서 늦는다.	3
응 좋아. 근데 엄마가 갑자기 오거나 할까봐 좀 걱정이야.	2
 이거 계산 좀 해줘.	6
미역국 삼촌이 끓이면 되겠네. 어차피 집에서 아무것도 안하잖아.	3
이번주 일요일에.	1
왜요?	5
아니 내가 식물위키에서 봤다고…	6
안돼..! 나중에 탈 거야. 나중에.	6
정말 좋은 방법이네요.	7
저는 더이상 못 살겠어요. 진짜! 저는 못 삽니다.	0
퇴근 시간에는 원래 다 막혀요.	6
네… 근데요 전도사님. 그럼, 엄마 곁에 빨리 가려면       저도 빨리 죽어야 하나요?	4
답답한 소리 하시네. 요즘은 민정이 때랑 또 달라요. 유치원부터 시작하는 애들이 태반인데.	6
그럼 나중에 애프터 하시면 돼요.	1
아빠 그런데, 주원이가 요새 좀 수상하지 않아?	3
역사가 만들어진 곳이기도 하죠.	3
2년 동안 열심히 하면 이안대학교 정도는 써볼 수 있지 않겠녜. 아, 이안대학교는 살면서 생각조차 한번도 안 해 봤는데... 멘붕이다.	4
안돼. 조금만 나중에.	6
너 혹시 도박 하니? 어쩌다가 갑자기 그렇게 큰 돈을 썻어!	2
그래… 아까 사십만원 정도라고 하지 않았어? 근데 여긴 다 일곱자리 숫자인데…?	2
"아이고. 잠잠하다 했다. 	 또 일을 벌리는구만. 	 그냥 책장 작은 거 하나 사고, 필요한 책 있을 때마다 왔다갔다 해."	3
네. 뭐. 근데 사진은 좀…	6
"니가 왜, 걔네들이랑 경쟁을 해. 	너는 나중에 경영을 해야 되는 사람인데."	6
아 연장했어요.	1
어디서 반말이야?!	0
저는 이런 낡은 느낌이 좋더라고요. 어렸을 때 갔던 시골집 생각도 나고.	7
 할머니 진짜 미워. 담부터 우리집 오지 마요!	0
한문학과는 뭐야? 너 한문 엄청 못하잖아. 너 중학교 때 한문쌤 누구냐. 그 신지은쌤? 그 쌤이 너 한문 못한다고 뭐라고 했다며.	3
나는 임신 하고 싶은데.	4
한창 바쁜 시간이라… 저희들이 제대로 확인하지 못하고 음료를 건네드린것 같습니다. 죄송합니다. 입이 열개라도 할 말이 없습니다.	4
이렇게 정정한데요 뭘.	0
 안녕하세요.	1
응. 기대만큼 재밌었어?	7
저.. 베개 맡긴 거 찾으러 왔어요.	1
 아이고. 마누라 사랑 받아서 어디다 씁니까.	6
오빠는 왜 말을 그렇게 해?	0
수석졸업? 나 그건 몰랐네. 진짜 대단하구나. 공부 엄청 잘했네.	5
응... 저번에 형이 그릇을 깼거든.	2
다음에 꼭 진짜 다시 데려올게.	4
 아 아닙니다. 근데... 우리 주민이가 뭘 잘못 했나요.	5
건강한 돼지 되는거지. 그래도 그냥 돼지보다는 낫지 않냐?	1
아니, 막 방귀를 많이 뀌는 건 아닌데… 보통은 연인끼리 있을 때도, 좀 조심해서 소리 안나게 뀐다던가… 정, 방귀가 마려우면 화장실을 가고 그러잖아요.	3
 지금 11시요.	7
우리 헤어지자.	6
응 선우랑 같이 계속 봤는데, 그냥 계속 혼자 있던데?	1
지금 부모님으로 되어 있긴 한데요.	2
예를 들어서, 민수가 준 돈으로 다른 사람들한테 돈을 빌려 주면서, 이자를 받는 거야. 그 받은 이자의 일부를 민수에게 주는 거지.	4
"어우, 감독님 이렇게 취하셔서, 누굴 책임져요. 	 본인을 우선 챙기세요."	6
겨우 모의고사인데 뭐. 친구들이 다들 열심히 공부를 하니까, 나도 그런 분위기 속에서 힘을 얻게 되는 거 같아.	4
"너야, 이제 한 시름 놨으니까 쉽게 말할 수 있는 거지.	 나도 동철이 자식, 취직해서 지 밥벌이만 하면, 바로 손 놓을 거다."	4
혜진아, 이렇게 혼자 힘들어만 하면 안돼. 왜 내색도 안하고 가만히 앓고만 있었어?	2
한숨 그만 쉬어.	4
모의 시험 만큼만 했으면 이미 합격이지. 왜 항상 본 시험에는 모의 시험만큼 못 볼까.	3
지희야 너는 결혼해도, 꼭, 일 계속 해라.	4
덥다 더워.	6
퇴근해서 내가 노냐? 맨날 대본 쓰고, 수정하고, 재확인하고. 얼마나 바쁜 줄 알아?	0
근데 길에서 하면 엄청 위험해요. 차도 씽씽 다니고, 자전거에 치일 수도 있고요.	6
어 근처에 한 군데 있다. 7시까지네. 지금 가자.	5
우리는 언제 데뷔하냐. 나 솔직히 연습실에서 스무 살 넘은 형들 보면 좀 불안하다.	4
아버지 그건 제가 다시 갚는다고 말씀 드렸잖아요..	3
<그날>의 인상적인 연기를 보고 대칠 배우님을 알게 되셨다는 분들이 많아요.	7
아니. 짝은 오빠가 나 못난이 인형 닮았대!	4
우리를 올라오는 게 아니라. 같이 올라가자고 같이. 손잡고.	0
 응? 손은 왜?	5
음…. 네. 기억 나요.	7
당연하죠. 제가 아마 고모를 닮았나봐요?	3
가자. 오늘 학교 끝나고 같이 가자.	1
 그렇구나. 알려줘서 고마워요!	6
아 진짜 먹는 걸로 왜 그래. 치사하게?	3
흠… 지훈이는 그러면 약하면 잡아 먹혀도 상관없다고 생각하는 거야?	1
아 맛있는거 먹고 싶다.	4
누가 너 보고 적금을 들래?	1
뭘 오해하시게 끔이야. 그냥 실언이지. 영업은 말빨인데, 이래서 뭘 팔아먹겠어?	0
아 응. 그거 향 좋아서 나도 하나 샀어.	1
아니… 그때는 살아보려고, 거짓말 한거지.	4
아니, 태권도 캠프 가는게 뭐가 무섭다고 이러는거야?	3
아 진짜…? 무조건 안된다셔?	1
어제 화장품을 잘못 썼나봐.	4
곰팡이가 눈에 보이지 않아도 포자가 날아다녀요. 그게 호흡기에 얼마나 안 좋은데요.	0
간병인 써야지. 그 비용은 내가 댈게.	6
쯧쯧, 세상 천치구만.	3
네.	2
테이프요? 무슨 테이프요?	5
남자가 바깥 생활 하다보면 그럴 수도 있지.	6
"핏줄이라고 또 와서 바득바득 따지는 거 보소.	 집 없는 사람은 어디 서러워서 살겠나.  머리 아프니까, 귀찮게 하지 말고 니 방에 들어가 있어. "	3
회사에서 동료들이 반찬 집어 먹어보더니 깜짝 놀래. 누가 만들었냐고.	7
나 다리 부러졌을 때.	0
하여간 어렸을 때부터 말만 잘해 말만.  저기요. 이방인은 재밌게 있다가 돌아가세요. 우리 일은 우리가 알아서 할게.	3
됐어. 다시는 안 와!	0
왜 싫어?	1
엄마한테 태블릿 사 줄거야? 나는?	5
원래 기억은 왜곡되는거야.	7
또 사줘? 너 왜 자꾸 컴퓨터 망가뜨려?	0
에,뭐라구요? 지금 말 다하셨어요?	0
그래. 내가 다음에 사줄 게.	1
 네가 친구들 사줘.	7
재밌대?	3
내가 처음부터 반말했어?	0
오늘 고등어 무 조림이랑 계란국이랑 차조밥이요.	7
그러게. 기상청이 일을 제대로 안 하나봐 요새.	0
내가 먹어 봐서 알아. 프랜차이즈는 자극적이서 금방 물리더라고.	4
한국에 언제 이렇게 카페가 많이 생겼대? 오 년 전까지만 해도 이렇게 여기저기에 카페 널려있지는 않았는데. 오랜만에 들어오니까 아주 별천지야.	5
우리 집은 안전하니까 언니, 맘 놓고 달리자! 	7
아이, 선배 몸을 엄청 사리시네.	3
아냐 할머니 여기 얼마나 재밌는게 많은데.	7
내 친구, 종훈이가 엄마랑 같이 카페 가려고 했는데, 노키즈존이라서 못들어갔대.	4
또 밖으로 나돈다고 니 속 썩이면 갖다 버려버려라.	6
약속!	7
아니… 제가…	3
아 그거! 말 해도 되나? 그거 말하면 안될텐데?	2
그래서, 고백은 언제 할 거야?	1
그러게요… 제가 갖고 있으면 안되는 물건이더라구요…	3
아 그리고 택배 박스를 왜 가위로 여는데? 그러면 날 다 망가져.	6
그렇지.. 그러니까 너도 감사한 마음으로 공부해. 너는 명절 날 맛있는거 엄청 먹으면서 잘 지냈지?	1
 또또 꼬투리 잡는다.	0
참 별일이네. 우리 땐 실, 연필, 돈… 이런 게 전부였는데 말이야.	1
아 이모 닭살돋게 왜 자꾸 칭찬만 해~	7
요즘 들어 바쁜가 보지.	6
그 아저씨 백수야?	5
까먹었어~	3
어디에?	6
"엄마가요.. 애들도 안 오는데, 뭐하러 돈 들여 파티를 하녜요..	 그냥 가족끼리 밥 먹쟤요.."	4
징징이.	3
일단 기다려 보자.	4
왜 무슨 일인데?	6
저 아르바이트 구한다는 글 보고 왔는데요.	2
너 입양했잖아.	2
학교에 가야지만 배울 수 있는 것도 있어~ 학교가 왜 싫은데?	4
그럼 다른 퀴즈 한 번 더 내봐.	2
진짜야. 토할거 같아.	3
얼마나 드셨나요?	5
목숨이 위태로운가봐.. 현관 복도까지 피가 흘려져 있고 난리도 아니었어..	4
밥에다가 물을 부어요? 그걸 무슨 맛으로 먹어요?       간장이랑 먹어요? 김치랑 먹어요?	6
 어….	2
교복입은 거 보면 고등학생 같은데?	6
너 말고 누가 먹었겠어 그럼. 동생이 잼 병뚜껑을 어떻게 열어.	0
만나자마자 임신한거야?	5
이 운동은 코어를 만들어 주는 거예요. 자, 힘 딱 주시고!	6
니가 알아서 치워야 엄마가 냅둘 거 아니야!  옷 벗으면 그 자리에 던져놓고, 가방 들고오면, 그 자리에 그대로 펼쳐놓고.	6
음...그럼 일단 이번 중간고사부터 오답 노트를 열심히 만들어 봐야겠다.	4
네. 감사합니다.	1
언니 여행 갔을 때, 승윤이 만나러, 그 집 갔는데 승지 언니, 집에 있었거든.	3
발끈하긴 뭘 발끈해, 니가 말도 안 되는 소리를 하니까 그렇지.	6
근데… 어제는 된다고 하셨잖아요.	4
왜, 그간 자식한테 그렇게 무관심 하더니.	6
엄마 없을 때는 언니가 엄마지.	1
 또 뭐! 뭐! 뭐!        뜸 들이지 말고 빨리 말해 이 기집애야.        난 니가 뜸 들이면 무서워 죽겠어 정말.	0
아… 번거롭게 만들어 참 미안합니다.	2
근데 왜 1등을 못 해?	3
거기서 쫓겨나서 여기 아니면 잘 데가 없어.	0
내가 바보냐?	0
아직 어디로 가실지도 안 정하신 거에요?	5
난 축구하는 게 좋단 말이야.	0
준호 취향이 쨌든, 니 쪽이라는 거잖아.	7
음… 뭐 가져가지?	1
"그런 말 좀 많이 들어. 	 근데 매니저 오빠는 어디가고 너 혼자 와?	 밤길 위험한데."	7
"엄마 나… 	가수하고 싶어."	4
저한테 괜히 희망 주지 마세요. 저는 선배 어려워요. 그 때도 그렇고 지금도 마찬가지에요.	3
뭘 찾는데?	1
내가? 야 내가 그래 뭐. 미남은 아니지만. 그래도 키는 크잖아.	5
네?	5
왜 불편해요?	5
아니 근데 내가 분명히 먼저 체육복 빌려달라고 했단말이야	3
장하네.	7
그거 진짜 싫어요.	6
그랬나. 모르겠어.        사실, 그냥 희망을 가지고 싶은 것 같기도 해.	4
너는 교우관계가 정말 좋구나. 비결이 뭐니?	5
그거 아픈 건 그냥 파스 바르면 돼.         죽을 병 걸린 것도 아닌데, 왜 이렇게 유난이야.	6
" 그럼, 시온이가 놀이터 한번 가줄래?	 삼촌이 없으면, 시온이는 바로 집으로 가있어. 알았지?"	3
"원래 집에서도 설거지는 내 담당이야. 	엄마가 자기 손 망가지면 안 된다고, 나한테 설거지 하라고 그래."	6
아 그런가요..? 저는 연장자가 먹고 싶은 것 먹는 건 줄 알았어요	4
다행히, 주변에 친구들이 있었지. 걔들이 나한테도 알리고, 119도 부르고 해서. 살았지.	1
그럴 거면 너 혼자 나가 살아!	3
다음에 한 번 놀러와. 밥 먹으러. 다들 너 보고 싶어하셔.	7
아 미안해, 정말.	4
정말요? 엄마 완전 거짓말쟁이네.	5
와 소리 엄청 깨진다. 귀 안 아프냐 이런 걸로 들으면?	3
요즘 핸드폰들 신기한 기능이 많긴 많더라.	5
그 게임회사에서 니들한테 상이라도 줘야겠다.	3
알겠어요. 근데 오늘 말고 나중에요.	0
요즘 삼겹살 가격이 좀 올랐다던데. 비싸려나?	7
아니. 내가 너무 떨려서, 입이 안열리는거야. 말은 또 엄청 걸고 싶고. 내가 그래서, 딱 그런 생각이 들더라고. 이게 사랑이구나.	2
그러다 노총각 돼.	3
근데 왜 그랬어?	0
너가 어떻게 키우냐? 너 스스로도 못 키우는데?	3
뭐야. 갑자기 그런건 왜 물어?	7
"아니…언제까지 차에서만 만나야 되나 싶어서. 	우리가 무슨 범죄 저지르는 것도 아니고. 	맨날 이렇게 숨어서 만나니까 잘못하는 것 같잖아."	6
좋은 거 하는구나. 근데 너 치약에 대해 뭐 아는 거 있냐? 갑자기 칫솔 치약?	5
철학…? 철학과에 가야겠다.	1
암튼, 그만하자. 우리 이제 쫑낼 때 됐어.	6
언제?	5
그래. 존중할게.	7
지금 몇 학년이라고 하셨죠?	5
아저씨 오늘 진짜 할 일 많아. 근데 여기 온거잖아. 니가 신고한거고. 맞아 아니야?!	0
 이거? 깜짝 초밥. 도로 가져 갈게. 주말에 먹어.	6
뭐하는 거예요 지금? 저 모욕하려고 불러 내신 거예요?	0
그게… 그 친구가 가구 공방을 그만 뒀다네.	2
방음소년단 티켓? 오빠. 그건 아양으로 될 일이 아니야.	3
저번에 밤 새고 집 들어가는 길에… 골목길에서… 주차되어 있던 외제차를 박았어.	4
전화도 안 받네. 이거 큰 일 났다. 야.	0
"불쌍하지, 내 새끼...	 얼마나 한이 됐으면, 아직도 못 올라가고 주위를 맴돌고 있을까...	 왜 엄마한테 안오고, 엄한 동생 꿈에 가서 동생을 힘들게 해..."	4
 어쭈, 우리 세형이 완전 문학 소년이네? 멋있는데?	3
 아니야~	6
돼지고기 생으로 먹으면 돼지고기 안에 있는 세균이 얼마나 많은데, 넌 지금 세균 덩어리를 통째로 삼킨 거야!	3
아니, 내가 내일도 촬영이 있는데, 새벽까지 촬영이 웬 말이야. 지금 들어가야 돼.	0
아... 네…	5
"알았어... 무섭게 왜 그래... 	 근데 신기하네, 진짜 나도 몰랐던 형이 어떻게 내 꿈에 나왔지."	4
아니 저번에는 많이 하면 학부모님들이 좋아한다고.	6
선생님 근데 그러면은 큰일나는 거 아니에요?             그 벌레에 막 독 들어있고 그러면 어떡해요?	2
안돼요. 걔 십년 만난 여자 친구 있단 말이에요.	5
좀이 아니었잖아, 걔들은.	6
내가 그랬나?	7
성환아… 이러지 말자 진짜... 응? 제발…	4
너 지금 민수랑 너랑 비교해서 그러는거야? 민수만 검은 띠 메고 다니는게 질투나서?	3
춤 연습하는 거?	5
이상하다. 엄마가 애기는 결혼하고 갖는 거라고 그랬는데.	6
둘이 좋으면 뽀뽀 할 수도 있지. 뭐 그런거가지고 호들갑을.	3
그게 아니라니까요? 같은 반이면 다 친구에요? 아니거든요.	0
오! 9,18 있어 있어! 계속 불러봐.	5
그랬었지. 손이 발이 되도록 비는데도 엄마가 막 때렸지.        근데 그 얘기는 갑자기 왜?	6
아니 그런 건 아니고. 헤어진 거는 아니고. 그냥 친구 공연 보러갔다가 거기에서 친구의 친구인 여자를 만났는데.	2
오만원이요?	5
한 시간 째 쿵쿵 대서 잠을 못자고 있어요.	0
갑자기?	1
아빠가 어릴 때 귀신 본 얘기 궁금해?	7
아니, 연락도 없이 이게 무슨 일이야. 왠일이야? 무슨 일 있어?	5
그러게.. 아빠가 이렇게 잘 하는데… 엄마 닮았지 뭐.	7
너 친구들 중에서 학원 안 다니는 애 있어? 없지?	0
 저거… 쓸 만 하냐니?	1
자꾸 이러면 나도 전남친 콜렉션으로 풀착장하고 나타날거야.	6
그 때까지 괜찮겠어?	5
야, 나는 어릴 때 아버지 생신 한 달 전부터 뭘 해드려야되나 고민하고 그랬어. 근데 너는 일주일 전인데 아무 생각도 안 했단 말이야?	3
와. 천생연분이네. 누군데?	1
에 뭐에요. 하나도 안 무서운데?	7
응. 떨어졌어.	4
"동그랗게 생겨서,  잡으면 냄새 엄청 지독하게 나는 거. 	 그건 눌러서 잡으면 안돼. 잡아다 밖에다 버려야지."	6
이제 꼬부랑 할아버지지, 뭘. 근데, 뭐 부탁할 게 있다고?	5
아니 그냥 내 얼굴만 보면 알지. 뭐가 더 필요해?	3
예. 저도 편하고 좋고, 아버님도 맛있는 거 드시고 좋지요.	4
여기 화장실은 어떻게 매번 물비누가 없어? 짜증스럽게.	3
왜요?	6
면도기로?	1
보일러로 연결된 호스가 빠졌는데, 모르고 온수를 쓰셔서 그랬나 봅니다.	7
만약에 누나가 잘못되면, 우리 가족들 다 얼마나 슬프겠어. 나쁜 선택을 하기 전에 꼭 우리 가족들을 생각해. 알았지?	4
언니가.... 희순이랑 왜 싸웠는지도 다 들었어.	4
주변엔 다 결혼해서 애들 두고 사는데, 나는 진짜 걱정이라니까.	1
그래. 아빠가 보기에도 딱히 녹물 같지는 않던데. 그래도 걱정이 되네.	2
맞아.. 애들이 미울 때도 있었는데.. 다들 나 때문에 태어난 애들인데.. 전부 내 책임이지.	3
맨날?	5
누가 그래? 그건 어디서 들었어?	5
없지 않을까?	3
너 하나 키우기도 얼마나 힘든데. 또 애기 낳아봐라.        너희 어머니가 또 일도 못하지, 몸 상하지. 얼마나 힘들겠니.	2
근데 할아버지, 그 도자기.. 할머니가 진짜 아끼던 거래요… 할머니 막 울었어요.	2
아빠, 근데 우리 어디로 가?	4
누나 친구 남편 중에 누가 있다고 했잖아.	2
아저씨 제발요…	2
진수 그 노므자식 안 되겠구만.	0
연애까지는 아니고. 그냥 좀 만나고 있어.	7
진짜 마음을 나눌 수 있는 친구는 없어.	4
너?! 야! 너 지금.. 너랬어?	0
뭐? 아까는 언제나 내 편이랬잖아.	3
거짓말하지 마세요. 9공 준비 중이시잖아요. 파워 에듀 다니시죠? 새벽반.	3
"바빠서 그래요.	 짐 정리도 이제 겨우 끝냈어."	4
뭐라고..?!	3
한 캔도 술은 술이지!	0
돈도 벌고 결혼도 해야지. 엄마 아빠 생각도 좀 해 봐.	2
나도 너만할때 아주 날라다녔어 나이 앞에 장사 없는거야	6
"나라에서도 외고나 자사고를 없애내, 마내 난리인데. 	대의를 해치지 않는 선에서 애도 합시다."	4
왜?	5
야 그래도 오빠지. 아저씨라니.          이렇게 젊은 아저씨 봤어?	5
아… 다른 가족은요?	4
공짜? 진짜로 공짜에요?	5
나도 당한 적이 있지. 아버지 없는 애라고 놀리고 그런 애들이 있었어.	4
"으이그 으이그. 잘 한다. 	 돈 벌어서 아낄 생각은 똥으로도 안하는구만."	6
오빠. 오빠 피아노 칠 줄 알지?	7
그 아저씨나 이 아저씨나 똑같잖아요!	0
얼마 전에 갔더니 장롱 구석에 있더라.	5
그러니까 이 놈이 노상 아는 척만 하지, 가만히보면 헛똑똑이여.	3
아….	4
"평소 같으면,어? 형이 이런거에 관심을 가질 	위인이 아니지. 뭔가가 있어야 관심을 가지지. 	엄마한테 가서 전해. 	궁금한 게 있으면 직접 와서 물어보라고."	6
이거 말하는 것 봐라?	0
어. 많이 좋아져서, 식습관만 잘 유지 한다면… 다음엔 당약을 아예 빼도 되겠다고 하더라.	1
어... 살 수 있긴 한데... 나래 호텔 주인 되려면 돈 많이 벌어야겠네.	5
그래? 어떤 점에서?	7
어떤 형이? 대체 어떤 형이 와서 결혼한다고 했는데?	3
너 합산이라도 올릴려면 기말고사는 무조건 백 점 맞아야돼.  기말고사는, 한 달 전부터 모의테스트 계속 돌릴 거야.	0
전 그냥 치킨 시켜놓고 집에서 봤죠.	4
어디?	5
음… 그냥 아주 달진 않은 단 맛이에요.	1
김집사 노래 못해?	5
그렇구나. 알았어요 그럼. 이제 안 뛸게요.	5
느이 엄마가 그렇게 가르치든?	3
그러니까요. 아니 교장이면 교장 답게 그냥 권위 있게 딱        교장실에 앉아만 있어도 되는 거를. 뭘 또 해보겠다고 설치니까.	3
음… 확실히 두근거리는거나 울렁거리는게 없어서 좋아. 맛은 비슷하고.. 다음에도 카페 가서 먹을게 없으면 이걸 사봐야겠어.	1
십 만원?	5
할아버지가 아빠보다 크지 않아요?	5
아니, 서로서로 편해야지. 저는 불편하다니까요?	3
지은아, 너 유민이네 집에 놀러가기로 했다면서?	1
은행놀이 가짜 돈 이런 거는 아니지?	3
알았어. 그럼 누나 말 믿고 한 번 해볼게.	4
돈이야 엄마가 다 버는데 싸울게 뭐 있어.	5
엄마가 여기 맡기신게 분명하다고 하던데요!	0
아니, 아빠한테 할 말 있다고 그러더라구.	7
다음에도 내가 할거야! 넌 신경 쓰지마.	7
그럼요. 그 마녀가 확 조용해지더라고요.	5
오른쪽 두 번?	5
그래. 과학적 이론은 제쳐 두고, 고기 좀 먹자!	7
얼씨구. 아빠는? 아빠는 평생 그렇게 놀 거 다 놀면서 살았잖아. 엄마 좀 내비둬. 그렇다고 엄마가 뭐 집안일을 놨어? 그것도 아니잖아. 오늘도 보니까 곰탕 한 솥을 끓여 놓고 갔더만.	7
 안녕하세요.	7
너도 나이 들면 다 알게 되어 있다, 지은아.	4
음… 약간?	1
아... 죽기 직전까지요?	5
그것도 무섭다면요?	7
 아 씨…	3
뭘 내 멋대로 해. 그만 좀 우겨.	0
안 돼. 그냥 그거 다 먹으면 사. 저번에도 유통기한 지나서 버렸잖아.	6
와 진짜 지옥이 따로 없었겠네.	3
선생님 정말로 감사드려요.         제가 이렇게 글씨를 쓰고, 읽을 수 있게 된게 정말 얼마나 큰 기쁨인지…	4
 너 뭐하냐?	3
아니. 어떻게 맨날맨날 발라. 귀찮은데.	6
네. 색깔이 할머니한테 진짜 잘 어울려요.	7
잘 모르겠어. 그리고 그 사람이 원하던 원하지 않던 나는 낳아서 키우려고.	4
내가 못 들어서 다시 물어봤어?!	0
 하면 어때? 좋아?	2
그래야지. 그래야지.	4
어? 혜지야. 니가 여기 웬일이니?	5
재밌어?	7
차가 치고 도망갔어.	4
안하던 짓 하는구나. 뭔데 뭔데.	6
아 다름이 아니라, 이번에 학교에서 조교를 새로 구하고 있거든요? 혹시 한 번 해 볼 생각 없나 해서요.	4
그걸 왜 니가 걱정해? 니가 계산할 것도 아니면서.	6
아직 안 드렸는데…말 해야돼?	2
편식쟁이라는 말은 어린 애들한테나 하는 말이고, 난 그냥 안 먹는 음식이 있다고 하는 게 맞지.	6
무슨 내용이야?	7
시험 끝나면 우리 학교 축제 한 번 놀러와.	5
 아.. 이 핸드폰이 잘 안되네.. 망가졌나..	3
정말 감사해요 제가 한턱 쏠게요.	7
그건 그렇지. 근데, 누가 이렇게 가고 나면, 후회밖에 안 남는 것 같애.         그건 그 누구의 잘못도 아니야. 그러니까, 너무 자책하지마.	4
자네라면 잘 해나갈 수 있을 것 같아서 하는 말이야.	1
네. 어머니한테 오늘 점검원 왔다고 한 번만 말씀해주세요.	3
그런 거였구나. 전 괜히 걱정했었나봐요.	4
심각한 건 아닌데… 놀라지 말고.. 다 괜찮아질거니까..	4
요금제는?	2
"어휴. 할머니 성질머리하고는 진짜. 	 아니, 할머니 멍든 건 오백 원 깎아줘요."	6
그 아버지가 공사 현장 이층인가 삼층인가에서 떨어진 벽돌 맞고 죽었잖아.	2
아. 나 잠깐 친구들이랑 놀았어. 그리고 밧데리 다 돼서 전화 못 받았어.	2
말 다했어요?	0
그래서 틀리게 된 거예요. 제가 부분 점수를 조금 드리긴 했는데. 그래도 성적은 B를 드릴 수 밖에 없네요.	0
엄마 아빠 결혼식 때 처음 보고 이번에 팔순 잔치 때 또 본거야? 거의 남이나 다름없네?	1
"아이구, 서준이가 제일 아끼는 걸 부셔버렸어?	 민준이 몰라서 그랬을 거야. 아직 아가잖아. 엄마가 민준이한테 사과하라고 할게."	6
그게.. 그렇긴.. 한데… 야. 여기서 기다려봐. 아빠가.. 가서 보고 올 테니까.  넌 여기 있어.	2
뭔 데요?	5
아저씨. 저 죄송한데 라이터 한번만 빌려주실 수 있어요?	2
누나 오늘 공연도 봤어요?	7
 하, 아주 자신감이 넘치는구나?	3
왜?	5
이거 내 커핀데?	3
무슨 알바요?	2
 오늘 저녁은 같이 먹을거지?	2
미안해 미안해.	2
그러니까. 현아 결혼할 때까지 건강해야 되는데.	7
음… 중소형차를 찾고 있는데…	5
몰라. 임마.	6
너 그렇게 태호 찼다가,  최준호가 너 안좋아하면 어떡할려고? 시력이 안 좋은 애는 흔하지 않아.	2
그래? 왜.	5
지금은 헬스장 가서 하고, 나중에 돈 벌면, 일 순위로 로잉 머신을 하나 사. 너무 너무 좋아.	1
어어? 언제 그랬어. 저번에도 별로 안 아팠잖아.	5
알겠습니다.	1
 아…	6
그럼 할머니는 어디 살아요?	5
오래 있었던 거 같은데, 오늘은 주말이니까 이만 가줬으면 하는데..	6
그래 정말 고맙다 지우야. 진짜로 고마워. 내가 재하한테 연락하라고 할게.	7
거짓말. 엄마가 할아버지를 어떻게 혼내.	3
맞아.. 은퇴하고 소일거리하시는데 그걸 어떻게 또 뭐라고 하겠어..	1
 감사합니다. 작가님은 너무 우아하세요.	7
"어.. 그럼 훠궈는 어떠세요?	 요즘 배달해주는 데 있던데."	6
어. 나는 날개가 다리보다 좋아.	1
위험한 거면, 하지마.	2
혼 안내고?	2
밖에 아무 소리도 안 들리지?	2
아빠 때문에요.	4
헐 진짜로? 말도 안돼. 진짜 티 하나도 안 나는데? 어떻게 그렇게 감쪽같지?	5
네 너는 건 혹시 어디에? 보니까 베란다가 없어서.	2
"그게 뭐가 좋은데.	 반 애들도 내가 어디서 뭐 했는지 다 알아!	 지난 주에 엄마한테 혼난 거, 올리지 말라 그랬잖아. 	 근데 아빠가 올렸잖아! 그래서 애들이 다 안다고!"	6
그럼.   내가 영감 잘못 만나서 그렇지, 고생하느라 폭삭 삭아서 그래. 젊었을 땐 볼만 했어~	6
에이, 엄마 무슨 그런 말씀을 하세요. 마음 넓으신 엄마가 조금만 이해하세요,	5
할머니 어릴 적에 일하느라고 못 다녔지.	4
아 맞다. 할머니 천재다.	5
 어, 너 왜 여깄어.	5
아... 그 정도로 싫어?	4
속고만 살았다니… 이 아들 마음이 찢어지네요~	2
한 달 용돈 10만원 받는데, 3-4만원짜리 케잌을 어떻게 사.	0
엄마한테 나는 뭐야 대체?	0
니 맘대로 하세요.	3
네? 뭐라고요?	2
괜찮아. 엄마 밖에 좀 봐봐. 바다 너무 예쁘지 않아?	7
운동이 당연히 힘들지.	0
돈이 모자라다 이거지?	0
그걸 제가 어떻게 알아요?	6
그거야, 감탄사잖아. 현타 이러는 데 못 알아들으면 어떡하냐고.	1
매 사랑을 끝사랑인 것처럼, 모르냐?	0
건물 앞에 그릇을 놨다구요? 아니 누가 그릇을 그렇게 멀리 내놔요?	0
야 솔직히 그건 기본 아니냐? 너는 기본이 안 돼있어.         애 아빠가 애 버릇을 너무 버려놨어.	0
"글쎄…. 화질이 안 좋아서 정확히는 안보이는데 어떤 여자소리가 계속 들리고	 둘이 호텔로 들어가….  요새 출장이 잦다 했어."	4
그래? 고생했네.	6
어.. 그렇다기 보다...	2
어, 그냥. 아무 생각이 안드네.	4
위로 위로 올라 가는거지.	0
너가 지금 따지고 들잖아. 내가 꼭 뭐 푼돈 벌어다 주고 유세 떠는 사람인것 마냥 말하잖아 너가!	4
어제 팔 때리고, 발로 차고 그랬어.	6
음.. 내가 설명해줄게. 일단, 직업에 대한 다큐멘터리를 만들어야 해.	1
요즘은 뭐 하고 지내?	1
선생님이 늦게 와서 그런 거니까 천천히 시작해요. 여자 친구 사귄지 얼마나 됐는데요?	1
꼭 민정이랑 나랑 아름이만 불러. 우리도 쉬는 시간에 놀고 싶은데.	6
아니, 이렇게 봐서는 곰팡이가 눈에 뵈지두 않는 걸 뭘. 괜히 긁어 부스럼 만드는 거 아니야?	0
네? 아니요. 그건 월급에 포함인 거죠.	5
응… 좋겠다…	4
어머 좋다야. 주방 완전 신식이네. 여기 몇 년도에 지은거야?	5
이번엔 진짜 바로 갚을게…	4
그러시구나…	2
아이, 자식, 어릴 때는 안 그랬는데, 까다롭게 구네.	3
이상한데… 그래서?	3
뭐?	5
그게 무슨 소리야 갑자기?	5
아, 나 진짜 급해요 아가씨.	3
그럼. 대신 배고픈데 좀 참아야 되는데, 괜찮아?	5
옛말에, 바늘 도둑이 소 도둑 된다는 말이 있어. 조그만 나쁜 짓이라고 아무렇지 않게 하는 듯이 되면, 나중에는 더 큰 나쁜 짓을 하게 된다는 뜻이야. 알겠니?	1
이모, 나도 돈 벌고 싶어.	4
뭐요? 영수증?	0
선생님~ 대답 빨리 빨리 해주셔야 집에 가서 주무십니다~ 성함 한 번 다시 확인 할게요. 성함 신이문 맞으세요?	3
누나 좋아하네! 야. 좋은말로 할 때 글 안내려?	3
"우빈이 책을 많이 읽는구나.	 <그날의 범위>도 한번 읽어봐야겠다!"	7
그래. 너 혼내는 거 아니니까, 무슨 일이 있었던 건지 다 말해 봐라.	1
어우 어쩌다 하나 쫌 알았나부다!  저번에 연하가 알려줬어?	6
아이 참, 애들이 다 그러면서 크는 거지 뭘 그래요.	0
내가? 뭐라고?	5
왜 그러셨을까요?	3
내가 누구 닮아서 못났는데.	6
난 공포영화도 못 보는데! 실습을 어떻게 하라고! 그게 어려운 건데 설득이 안돼.	6
"선생님이 해주실 수 있는 거 없어요. 	누가 절 괴롭힌다고 해도 기껏해야 학폭위 열고, 	벌점주고, 빡쎄면 징계주고 그런 것 밖에 없잖아요. 	그게 근본적인 문제를 해결해주지는 않아요."	4
어? 왜 그러세요?	5
"아 미리미리 말을 좀 해주던가. 그러면 돈을 좀 모았을 거 아니야. 	여행도 안 가고. 개강 전에 이렇게 말해주면 어떡해."	0
아니, 그 아줌마한테, 나라에서, 돈을 주는 거에요. 아버지 돌봐 드리고 돈 받지.	5
엄마? 엄마도 아침잠이 많아?	5
음… 미미 잘 지내는지 물어보자.	1
중고로 하나 뽑던가. 나 아는 친구가 중고차 하는데. 한 번 물어봐줘?	7
네.	1
걔 얘기 꺼내지 마. 이름 듣고 싶지도 않아.	3
그래. 건강 잘 챙기고. 혼자서라도 하루 일과를 규칙적으로 보내려는 노력을 해 봐. 그래야 검정고시도 잘 볼 수 있을거야.	4
선생님… 제발 부탁인데, 엄마한테 저 빠졌다고 말 안하면 안돼요? 앞으로 잘 나올게요.	2
그래. 알았어. 내가 모르는 거 있으면 물어 볼게. 좀 알려줘.	1
우리 반에.. 냉방병 걸린 애들이 엄청 많더라고.	4
아니. 어차피 죽을 거 하루 일찍 죽으나 늦게 죽으나 뭐가 달라지겠냐.	4
"잘 들어가시긴. 거의 억지로 끌려 들어가신 거지.	  고려장이 이런 느낌인가 싶다."	4
에이.. 그건 아빠가 억지 쓰시는거죠.	3
지금 여기에 너 말고 내 방에 들어가서 프라모델 부술 사람이 어딨어!?	0
야 소름끼치게 그런소리하지마.	3
...엄마, 나 걔랑 헤어졌어.	4
"양육권 변경은 아이의 적응을 위해서도 지양되는 부분이기 때문에 	단순한 바람만으로는 승소를 보장할 수 없습니다. 아이와의 관계는 좋으신가요?"	1
헐 완전 똑똑해.	5
너는 진짜. 너 콩이 데려올 때 뭐라 그랬어?	0
근데, 실은 나. 너보다 훨씬 더 좋아하는 사람이 있어.	2
네? 뭘요?	0
그 쪽이 책임자유?	5
맞아. 경비 아저씨 어디 휴가라도 간건 아니지? 요즘 갈 때마다 안 계시네… 나도 얼굴도 못 본지 엄청 오래 됐어.	1
할머니.. 내가 할머니 걱정을 얼마나 많이 하는데 그래.	7
하기야.. 그렇게 오래 지내면, 힘들지.	4
아 맞네!	5
엄마 우리 회사 변기에서는 음악도 나와… 제발… 우리 이 집에 산지 20년도 넘었어. 변기 바꿀 때 된 거라고.	3
어디 봐요! 얼마나 물어뜯기신 건데요!? 병원 가봐야 하는 거 아니에요?!	2
 아! 놓쳤네.	6
헐? 사귄지 일주일 만에? 너무 느린 거 아니야?	5
완전 다르지.	5
요새는 뭐 대학이, 취업학원이란 소리를 듣는 판에, 어쩔 수 없는 일이지.	4
솔직히 너무 돈벌이 용이어서…	2
"너희 아빠랑 나는 어렸을 때부터 살가운 부자 사이는 아니었어. 	내가 일이 바쁜 게 항상 너희 아빠한테는 불만이었지."	4
아이 뭐 이런 걸 줘. 됐어. 나중에 김치나 받으러 와.	6
 와 지금 나 협박하는거야?	7
"그러니까 말이다. 내가 이 나이 먹고 	너 해장국을 끓여다 바쳐야겠냐? 	한 평생 해장국을 끓였는데 손주 때문에 또….내 인생 해장국 끓이다가 다 가겠네."	3
평소에 잘하자?	6
아 정말요. [프렌즈], [골든걸즈], [빅뱅이론] 같은 건 정말 대안가족에 대한 내용이죠.  신기해 신기해.	5
나는 겉보기에만 멀쩡해. 속은 관절염에, 하지정맥류에 난리야 아주.	0
야. 그냥이 뭐야.  이모 결혼식 날인데, 인심 좀 쓰지!	6
맞으면서 왜 숨기냐고. 맞잖아… 아니냐고.	3
뭐? 너 진짜… 막 되먹은 애구나?!	0
"진짜로 안돼요. 제발요! 	저희 엄마 진짜 무서워요."	2
"그럼 조금 더 멀리 떨어질까?	  한 이쯤...?"	7
그럼 왜 그러지?	6
안녕히 계세요.	1
아니, 제가 어떻게 아줌마를 믿고 여기서 또 집을 보겠어요?	3
자기전엔 영어 단어 외워야 돼요… 그래야 잘 외워지거든요.	3
알았다니까요? 아휴 잔소리쟁이.	0
박사장도 나중에 먹으면 되지. 자식들한테 제주도 한 번 보내달라고 해.	2
너는 커서 뭐가 되고 싶니? 장래 희망 말이야.	1
점심 먹고 가면 안돼?	6
아는 게 힘인데...?	7
그냥…호기심에.	6
아, 그게 무슨 느낌인지 잘 모르겠어요.	2
예찬이네. 예찬이네 고양이 엄청 큰데 나 맨날 만져.	1
노조 같은 건 빨갱이들이나 하는거야.	3
 아니 그건 안돼.	7
응. 나는 재미있는 이야기가 좋거든.       그래서 사람들한테도 들려주고 싶어. 예를 들면 외계인 이야기 같은거.       사람들이 모르는 엄청난 사실이 많거든.	7
" 아휴. 알았어. 아빠랑 얘기해볼게.	 ...너는 엄마아빠랑 떨어져 사는 게 안 무서워?"	4
그러니까 이번에는 할머니도 먹을 수 있게.. 응?	7
향수는 저번에 줬어… 지금 내 고민이 뭐냐면, 남자친구가 너무 부자라서 이미 필요한 건 다 있고, 다 비싼 것들밖에 안 쓴단 말이야.	4
"공부는 원래 하기 싫은데.	 숙제가 없어도 공부는 원래 별로에요."	6
"오늘 저녁이요? 	아…오늘 저녁은 힘들 것 같아요."	6
그러지 말고, 노트에 그림을 그려봐. 맨날 오십 개씩 그리면, 금방 일걸?	1
나도. 얼른 무대에 서 보고 싶어. 형이랑 같은 팀 되면 좋겠다.	4
거기 넣으면 내가 쓰레기통 뒤져야 되잖아.	4
그렇구만. 그래도 오랫동안 살았던 집인데, 정들었을 거 아니야?	4
" 어이가 없어서 잔소리할 의욕도 사라지네. 	 영양제라도 챙겨먹어! 알았지! 아니다 지금 사러 가자!"	3
아니 그리고 너같은 꼬맹이한테 이렇게 비싼 걸 사주면 어떡해? 그러다 잃어버리면?	2
착하다 우리 아들 멋있네!	7
영화과?	5
 우리가 이룩한 문명은 실로 대단하지만, 사실 우리의 뇌는 원시인의 그것과 크게 달라지지 않았다지?	5
아니 나 진짜로 거기서 점심 먹고 싶어서 회사 다니고 싶었다니까?	7
근데 어떻게 엄마하고 결혼을 하셨어요?	5
네에-?	7
 아! 4월도 칼국수 집이었어?	4
응. 그랬나 봐. 아….. 진짜 속상하네.	4
훈이 걔 자리에 새 알바도 하나 구해야 되니까. 너 혹시 주변에 아는 애들 있으면 꽂아 줘.	1
그게 뭔데?	1
" 네…  사자가 없었습니다!	  그래서…아빠가 땀이 나서…조금 화가 났…"	2
아이, 벌써 선거철이 또 다가오는구만.	1
그래? 아빠는 요즘 보기 시작했는데, 이튜브 보니까 꼭 공부가 아니더라도 자기가 관심있는 것들을 잘 파고들면 돈을 많이 벌더라.	7
당신 내가 처음부터 마음에 안 들었어!	0
그런데 동생아. 너 A여대 지원한다고 하지 않았었나?        거기에 가고 싶은 과도 있다며.	5
선생님. 저도 알 거 알아요.  애들이 저 별로 안 좋아하잖아요.	4
돈 보고 가는게 맞는거 같아. 왜냐면 그게 내 가치를 증명하는 세상이잖아.	3
아빠, 뒤주가 뭐야?	5
비아냥이 아니고 그냥 충고하는거야!	3
집안일 하려고 여기저기 다니면, 티비로 보기 불편하잖니.         근데 핸드폰으로 보면, 부엌에서도 보고, 거실에서도 보고.         아주 편하다.	6
글쎄.. 아까 버렸나.	1
네. 저는 경영학과 쪽으로 가려고 해요.	1
다시 태어나야돼.	4
차? 차는 갑자기 왜?	5
 방마다 다 컨셉도 다르고… 내용도 다르다고요! 게다가 이건 제일 어려운 난이도 방이잖아요.	0
그래도 어쩔 수 없어. 가서, 여기 아파트는 전단 금지라고 말해.	0
" 아까 학벌 따지는 게 고지식하다며! 	민주가 여자인게 뭐가 어때서?"	0
아니요! 저 여자친구요!	6
그러니? 너 온다고 머리 좀 했지~	7
내가 너 별로 안 좋아하는 건 알지? 짧게 용건만 말해.	0
"주로 중국이나 러시아? 쪽으로 많이 나가지. 	러시아에서 만났어."	4
우리 엄마도 그 영화 좋아해요.	7
요즘에 누가 스물 넷에 결혼을 해?	0
니가 고칠 수 없는 거야?	5
좋긴 뭐가 좋아. 지금 눈 뜬 채로 지갑 털린 격인데.	3
그랬지.	1
애가 무슨 애를 돌봐. 애 돌보는게 얼마나 힘든데.	2
날 위해서 그랬다는 거 순전히 핑계다 그치?	3
 아!!!! 내 이십대!!!!! 좋은 날 다갔어!!! 	2
근데 고모 엄청 많이 먹던데?	1
야, 나는 내 친구 동생이 너랑 같은 반이라길래 얼마나 반가웠는줄 알아? 기껏 반가워서 물어봤더니 귀찮다고만 하고.	4
요즘은 다 무선 이어폰 쓰니까… 그런거 쓰라는거지.	3
"네.. 근데요...	 할아버지가 자꾸 어디로 데려갈려고 해요."	2
왜? 와이프랑 많이 싸워?	6
그런가? 근데 좀 큰데서 하려면 시내까지 나가야 하는데,             어르신들 다 오실 수 있을까?	5
"엄마도, 인생이 허무해서 그래. 	 뭐라도 사람구실을 하고 싶어서."	6
그냥.. 영어가 너무 싫어요.	6
하필이면… 교회 사람들한테.	2
너 어떻게 듣자마자 바로 엄마한테 얘기할 생각을 했어? 어떻게 그럴 수가 있냐구.	0
아 맞다, 근데 요즘에는 다 후불제라더라.	5
응. 근데 실수니까.. 실수면 별로 안 혼나.	1
꼬마야. 너 일로 와봐.	0
어머니도 이 사실을 아셔?	3
강인이 너가 음료수 더 마시고 싶다고 했잖아. 여기는 원래 1번 까지는 리필을 해 줘. 그럼 가서 해달라고 하면 되는거야. 간단하다니까?	5
가방 열렸어요.	7
저녁은 뭐 먹을까? 엄마 먹고 싶은거 먹자.	7
네!  여기.	2
그게 엄마였어요?	5
나는 좀 배고픈데? 너 점심 언제 먹었는데?	1
세상에... 견인이 진짜 되는구나.	5
그런가? 그냥… 책 보는 시간 만큼 남들과 어울리는 시간이 적으니까… 친구가 아주 많지 않은 걸 수도 있고. 잘 모르겠다.	4
 어 재밌어.	7
응. 맞방귀.	1
이번 달 까지는 보게 해줘야지. 이번 달 까지는 반반 냈잖아.	0
아 누나가 무슨 상관이야.	0
내가 뭐든 할게. 어? 시키는대로 다 할게.	4
뭐?	0
있지?	5
내 말이. 너무 뻔뻔하지 않아?	1
왜 그래? 그날이야?	5
 왜 이러세요!	0
왜? 무슨 일이야..?	5
선생님이랑 상담하니까... 그런 마음이 생기더라구요.	7
어우. 지금까지 굴러가는 게 용하다. 이제 보내주고 새 차 좀 뽑아.	5
솔직히… 어…	4
어차피 실업계니까 취직해야지 뭐.         자격증 따고 있어.	4
뭐로부터 보호하신다는거에요?	3
도시락은 갑자기 왜? 급식 먹는 게 여러 모로 편하지 않아?	5
제가 지금 국어 공부하려고 여기 나온게 아니구요… 빨리 본론만 말씀하세요.	0
아닌 것 같은데... 잠시만요. 엄마한테 전화해볼게요.        	2
진짜 별로네. 세상에 왤케 이상한 놈들이 많냐.	6
"에??? 피부과???	 안티에이징같은 소리 하네. 호박에 줄 긋는다고 수박되냐?"	0
뭐 해봐서 나쁠 건 없지 않을까요? 그래도 같이 산 정이 있는데,         형수님도 마음 흔들리실 수 있잖아요. 그리고 집에서 진짜로 변화하는 모습을 보여주세요.	6
"정말요? 막걸리를 직접 담글 수 있어요? 	그거 불법 아니에요?"	5
밥 그릇 치우는 거.	0
너처럼 꼬맹이가 피곤하긴 뭐가 그렇게 피곤해?	3
응. 할아버지는 수학을 싫어해서, 대학도 못 갈 뻔했어.	3
왜. 뭔데. 기저귀 같은거야?	6
발레학원? 갑자기 왜?	5
헐! 엄마 짱! 다녀올게요!	7
나도 모르겠어...	4
아니 오른쪽이요. 오른쪽, 오른쪽.	5
그래그래. 대 실업 시대에 일복이 터졌으니 얼마나 좋아. 일하러들 갑시다.	3
당연하지. 당연히 줘야지!	1
어머.. 나는 그런 줄 아예 몰랐지.	5
저기 보니까 프리미엄 돈까스 집 생겼대.	5
괜찮아. 내가 지금 운전해서 병원으로 가볼게.	1
아니면?	3
인터넷 어디서?	6
내가 이것만 보는게 그렇게 보기 싫은가봐.	6
언니, 춘자 우리 계모임에서 빼면 안 돼?	3
얼마나 졸랐어?	1
네. 다음부터 안 그럴게요.	4
으휴, 그깟 운전면허 하나 가지고 유세는. 내가 운전 면허 있었으면 내가 나갔을텐데.	3
알았어 알았어. 지금 할게. 흥분 좀 하지 마.	3
응. 그건 쉽잖아.	1
어. 뱀. 아주 오래된 술이야. 40년도 더 됐어.	1
너 말이 그게 뭐야.	0
너는 무슨 말을 그렇게 하니? 내가 너네 차별 안 하려고 얼마나 노력하는데.	4
죄송합니다. 죄송합니다.	2
그치? 근데 진짜 맛있다.	1
저… 그냥 앞으로 취업이 될 지, 그런거 여쭤보고 싶어서요.	2
나 무시해?	3
네, 아까부터 자꾸 고개 숙이고 숨으려고 하더니… 자세히 보니까 바지에 오줌을 쌌더라고요.	4
그래서 나보고 어쩌라구요.	3
문 잠궜어?	2
재경이?	1
참네…! 기가 막힌다. 기가 막혀.	0
잘못했습니다.	4
아닌데?	5
우리 학교랑 완전 딴판이네. 여긴 분위기 완전 헬인데.	3
방금 얘기했잖아… 나 다 듣고 온 거라고.	3
응. 나는 너의 모든 것이 걱정돼. 그니까 누나 걱정하지말고. 시간있으면 나가서 뛰어놀라.	1
그래?	5
근데 약을 사온다고 바퀴벌레가 없어질까?	7
무슨 소리냐 남사스럽게. 이혼은 무슨.        한 번 같이 살겠다고 약속 꽝 하면 그냥 평생 같이 사는거야.	6
당연하지. 애들 입장에서 언니 농사 짓다 다치기라도 해봐. 그게 더 골치지.	6
난 꼭 게이 친구가 있었으면 좋겠는데, 엄청 재밌고 편할 거 같거든.	6
…………..고마워.	7
응? 왜?	7
삼촌도 알잖아. 요즘 불경기라서 잘 안 팔리는 거. 아주 죽겠다니까.	4
늦기 전에 얼른 가봐요. 애들은 진짜 큰일날 수도 있어요. 얼른 얼른.	2
대박. 그 시절에? 어떤 수술?	5
정비를 자주 봐야겠네요…	2
그… 정책이 그래서..요.	2
점심 뭐 먹을래?	4
응. 정택수.	1
게임보다 책이 재밌다고? 난 그렇게 말하는 사람 난생 처음 본다.	5
말하면… 화낼 거지?	2
응. 다 별로였는데 진짜 감자튀김이 그렇게 맛있대.	7
왜 이렇게 오랜만에 오셨어요. 무슨 일 있었어요?	2
응. 우리가 윤지를 잘 보호하자. 근데 윤지한테 너무 바람 넣지 않게 조심해 당신도.. 윤지가 더 과격하게 행동하지 않도록 인도하는것도 우리 역할이니까..	2
그러게. 그럼 너랑 같이 가면 되겠다. 이따가 저녁 때 갈까?	4
이거 꼭 먹고 싶은데...	4
니가 무슨 눈썰미가 좋아~ 좋아서 머리한 것도 이제 알았냐?	0
아, 추천서. 그래. 써줄게. 그게 뭐 어렵다고.	5
어제.	7
나도 가야 하는데, 비행기 타는 게 힘들어서 고민이야.	2
야 젊은 사람들하고 나하고 같냐? 괜히 또 허튼 거 눌렀다가 망가지면 어떻게 해?	0
 네.. 분명히 그러셨어요 조교님한테 프린트 내용 확인하라고도 하셨고요	3
그거… 그러니까 우리 아파트에서 대대적으로 조직을 구성해서 들고 일어나야겠네요.	0
아.. 어른들은 왜 이렇게 맨날 피곤해해? 일 년에 몇 번 보지도 못하는데 좀 놀아주면 안돼?	0
왜?	1
우리 애가 먹고 식중독 날만한 음식은, 명란 뿐이었다고요. 제가 지금 뭐가 아쉬워서 사장님 붙잡고 죽는 소리 하겠습니까?	0
아씨 그럼 어떡하지? 야 개그감 키울라면 뭘 해야 되지?        예능 같은 걸 많이 봐야 되나?	0
형도 아직 중학생이잖아.	3
엄마 닮았나봐. 너네 엄마가 어렸을 때 피부가 너무 하얘서 우리가 백설공주라고 불렀거든.	7
끝까지 비아냥 거리네?	3
이모... 내가 생각을 해봤는데.	7
그건 그러네. 아 희진이한테 뭐라고 얘기하지?	2
아니야 진짜 고마워.. 살다 보니 가족 밖에 없더라.	1
아니 내 돈으로 산 치약인데 내 맘대로 못쓰냐?	3
얘기 들었어요?	7
어, 선생님.	7
꿈에서도 이런 이야기들.. 내가 겪었던 것들이 떠올라서 잠도 제대로 못 자요.	2
그러게. 요즘 배우들 답지않게, 아주 이목구비가 뚜렷하더라고. 그 배우가 원래 유명한 배우인가?	5
 가자. 가자. 가자.	1
아무리 간병인이 있다고 해도, 그 분 퇴근하시면 니가 아버지 돌봐야 할텐데 내가 그 정도는 해야지.	6
오. 채식? 갑자기 왜.	5
그래. 아, 그러고보니 지은이 네가 중학교 때도 전교회장 했다고 그랬었나?	5
들어오긴 뭘 들어와, 이제 9학년인데. 아주 대학까지 다니고 올 모양이더라.	6
글쎄…. 그래도 힘이 약해지지 않을까?	2
자네, 애들 생각은 안 하나?	6
언니에게 일부로 접근했다고?	2
아.. 너무 섭하네요. 그래도 그동안 형님 처럼 생각했는데…	4
너 김모모 알아? 김모모가 그렇게 잘 나가? 유명해?	5
나도 조금 더 알아봐야겠네. 집주인들이 좀 꺼려하더라고.	6
와... 이래서 내가 집에 자주 안 오는 거야. 오면 뭐 좋은 소리를 듣기를 해. 오다가 다치기나 하고.	3
아줌마? 야 내가 너보다 어려!	0
뭐 사달라고 하는 꽃뱀은 하수지 임마.        여자가 뭐 말 안해도 정현이가 알아서 이것저것 사다가 바치는 것 같더라.	4
나도 많이 좋아해.	6
아이고. 요즘에 아침상, 마누라 있어도 받기 힘듭니다.	6
그렇게 말하는게 더 무서워.. 그 형도 엄마 아들인데… 안만나도 괜찮다는 게 이상해…	4
그거 싼거 사면 한 2만원 할걸?	7
 그래. 서비스 많이 넣어줄게. 한 시간?	7
혜정이가 너 두배는 벌 거다.	3
흠.. 거기 갈비 맛있어?	1
"지금부터 조용히 하면..?	 그럼 언제 할 수 있어?"	6
운동은 따로는 안하는데, 제가 몸을 많이 쓰는 일이라서 운동하는 거랑 진배없죠.	6
취소 안돼?	2
에이, 안돼 그게 보통 일이겠어..	5
너 뭐하는 자식이야?	3
" 아 유치하다 유치해.	 빨리 니 갈 길 가고, 웬만하면 내 눈에 띄지 마라."	3
요 주변에 물가라도 있나? 멀끔하던데?	1
다르긴 다르지만… 아무튼 나한테 그렇게 말하지마 속상해!	0
어머, 걔가 여길 왔어?	1
그거 뭐 들고 가기도 귀찮고.	1
 니가 자꾸 팩폭하면서 돌려까잖아. 그런건 왜 묻는 건데.	0
나도 지금 학생 때문에 장사도 못하고 말싸움 하고 있잖아!	0
네 저 매 년 가는데요?	2
네, 박 교수님도 강의력이 워낙 좋으시니까, 학생들이 좋아하더라고요.	7
그러면 어떡하지?	5
장모님이… 문어 좋아하셔…	2
이 정도로 허리가 아플려면 디스크여야 되는데.. 디스크 있으세요?	6
에이, 그래도 커피를 그렇게 많이 마시면 건강에 좋지 않다고 하더만.	1
난 별로던데.	6
이 자식, 만나면 아주 뒤통수를 한 대 쳐줘야 겠구만. 우리 딸, 속상하게 하고!	3
범인이 밝혀지기 전에 누구의 소행인지 이미 알아채셨죠?	3
하.. 다들 너무 똑같은 걸 물으시는거 아니에요?	3
언니가 다른 동생이 어딨어.	0
아까 수업 시간에 얘기했었잖아. 너 진짜 마음 있으면      유사모 애들이랑 같이 가자.	7
응. 그래서 오늘 늦는다고 했었어.	4
그러게나 말이다.	6
너 아직도 잘못했다는 소리 안하고!! 계속 변명만 해!?	0
아아 엘성.. 저희 지금 엘성 충전기가 다 다른 핸드폰 충전 중이라서요	4
너 희정이한테 아직도 고백 안했냐?	1
아빠 원하는 대로 해 그냥?	1
선생님은 고등학교 때 수학 잘 하셨어요?	5
지금 이대로가 더 좋아.	7
누가 말해 주긴 엄마가 말해줬지. 너 치킨 귀신이라며.	6
습관이 되서 그런가 보다.	1
 응. 왜?	1
대문짝만하게, 에어컨에 단서 없으니까 뜯지 말라고 되어 있는데, 왜 뜯어 발겼는데! 어!?	0
 아고. 로미오와 줄리엣도 아니고.   얼른 나이 먹어서 미자 탈출하자.	3
엄마가 뀐 거 아니야!? 나 진짜 억울해!	3
" 	반 밖에 이해를 못하면 문제가 있는데."	6
노잼이야? 처음에는 괜찮다며.	3
아니… 그런건 아니고…	1
그리고 제가 부장님 들어오시라고 했는데, 왜 이과장님만 오셨어요?         지금 저 무시하시는 건가요? 이걸 어떻게 받아들여야 되요?	0
그래? 벌써?	5
 나한테 일이랄게 뭐 있니. 니네 아빠 빼고는.	3
어느 정도 나잇대가 되면.. 운동을 너무 심하게 하면 오히려 과부하가 온다고들 하잖아. 건강한 몸을 유지하는 것도 좋지만.. 그런 대회에 나가면서까지 운동하는게 좋을까 싶어. 더군다나 그런 대회는 젊은 사람들이랑 다 같이 어울려서 시합하는건데. 물론 승패가 중요하진 않다고 해도.. 사람이 운동 하다보면 괜히 경쟁심이 생기기도 하잖아.	2
어. 또 봐도 재밌어.	7
응. 너네는?	1
 선생님.	2
그걸 언제 사다 줄건데! 난 지금 아이스크림 먹고 싶어서 사다 놓은 건데 나중에 언제 사다 줄 거냐고!	0
 감사합니다.  캬.	7
그런 일이 있었구나. 이 얘기 다른 친구들한테 한적 있니?	5
와. 이 선생님 안 되겠네.	0
"그거 너무 달지 않아?	 난 이거 괜찮던데?"	6
누나, 안 생기는 애들은 SNS해도 안 생기더라.	3
다리 찢기요?	5
글쎄에~	1
"어, 되게 혼란스럽네?	 준호야, 혹시... 이거 태몽인가?"	6
나도 몇 년 전에 우울증 치료 받으면서... 많이 좋아졌어요. 임의로 약 복용 중단하지 말고. 잘 치료 받기를 바랄게요.	4
네.. 분명히 지난 주에 그러셨어요. 그래서 120쪽 이후는 다음 달에 하고 이번 시간에는 빠진 부분 한다고 하셨거든요	3
현관문 앞에다 내놨는데요?	1
그 형은? 그 뒤로는 어떻게 됐는데?	3
내년에. 사야지. 돈 모아야지.	4
에이 아니에요. 선배님은 선배님 할당량 다 끝내셨잖아요.	5
아 뭐야.	0
크루즈요? 그건 뭐에요?	5
나가라고.	0
맞아.. 건강을 위한 건데. 이게 나중에 우리 몸에 어떻게 작용할지 어떻게 알겠어. 속는 셈 치고, 사자.	1
뭔데요?	5
아니, 마스크가 좋잖아~ 목소리도 좋고.	7
그럼 아빠 닮았지. 엄마는 천사였잖아.	0
지금으로서는 상상이 잘 안 되네요.	5
응.	1
아까 다 먹었잖아. 얼른 숙제 안해?	0
아 몰라, 캐묻지 마. 창피해.	0
아니 옷이 너무 학생같지 않아서...	5
에이 엄마 꺼는 진작에 준비했지.	5
아무래도 안되겠네요. 제가 CCTV 돌려보는 수 밖에는 없겠어요.	3
이거 먹고 떡볶이에 오뎅국물 어때? 오늘 내가 다 살게.	7
너 무슨 일 생기면 꼭 나한테 말해야 된다.	5
휴…… 너 진짜 왜 그래.	6
그간… 월세 한번 안 밀리고 꼬박 꼬박 넣어드렸는데… 어떻게 이러실 수가 있어요?	4
그래도 신경써서 사과 식초 넣었는데… 표독스럽다니 너무 하시네.	0
알았어.. 그럼 엄마랑 같이 어디로 전학 갈지 알아볼게.	7
아이고 감동적이다. 내동생이 날 이렇게 좋아하다니~	1
학폭위가 뭐야?	2
니가 어떻게 사주는데.	3
"나는 항상 그렇게 먹었었는데 뭘. 	괜찮아. 신경 쓰지마."	7
너만 입이냐? 나도 먹고 싶었는데. 	0
니 젓갈집 간판 내가 내린다. 넌 끝났어.	0
내가 누누이 말하지. 설탕 듬뿍 넣으라고.	0
네.	4
그냥 다른 남자 애들 한테 빌려봐.	6
[리그오브레볼루션]도 해?	5
그랬는데?	1
 아 왜요.	2
여기 콩나물 어디에 있어요?	7
아니에요. 무슨 일 진짜로 없어요.	6
알았어. 건강 관리 잘 할게 .	1
말고는 없어? 고기 같은 거?	7
요즘 당신 좀 변한거 같아.	3
어.	7
그래. 봐.	7
가엾다 그 여자.	3
양치기 소년 같은거죠...  다들 뉴스 보기 전까지는 아예 아무도 믿어주질 않았거든요.	7
부산은 왜?	5
그럴까? 근데 엄마는 피자 안 좋아하는데.	6
너 그때 나한테 미팅 시켜달라고 조를 때 아니야? 내가 듣기 좋게 거절하려고 무척 고생했었는데.	3
야! 넌 그 유행가도 모르니? 나이는 숫자에 불과하다 잖아.	3
그 따위라니. 무슨 말을 그렇게 하세요? 아니, 막말로 아줌마는 지금 뭐 아저씨가 자리에서 벌떡 일어나기라도 할 것 같아요?	5
음.... 지갑은 이미 좋은 걸 쓰고 있고, 남자친구는 시계를 안 차.	4
화장실 갔다고 하면 돼죠.	3
안 돼.. 그네 부수면 안 되잖아.	4
성동이 앞에서 그런대?	3
아 그렇군요. 그럼 귀국 한 이후에 영어 공부는 어떻게 했나요?	7
에이 팀장님 진짜. 내 취향을 너무 정확히 아시네.	7
그럼 헤어져야지.	4
좋으니까 했지.	6
핸드폰 바꿔주면 안 될까?	2
거봐. 이렇게 잘못 인정 안 하고. 그런 태도가 문제예요 문제.	0
뭐요? 지금 남의 커피 훔쳐 들고서 인신공격까지 하시는거예요?	5
여기 끈끈이 잔뜩 묻었잖아.	6
핸드폰이 꺼져있으면 엄마도 걱정하시겠네요..	4
우리 애 아세요?	2
잠깐만 잠깐만.  할아버지가 용돈 주마.	7
그래요. 모르겠는 거 있으면 아저씨한테 물어봐요.	7
말을 왜 그딴식으로 해?	0
무서운 얘기요? 귀신 얘기에요?	2
엄마 나 축구부 들어가면 안돼?	4
세상에… 그렇게까지 해줄거야? 고마워!	7
 너 그거 뭐냐.	0
전 분식이 좀 땡기는데 앞에 분식집에서 떡볶이랑 순대 어떠세요?	7
야… 이러면 나 언제 태블릿 사.	1
아예 쉬고 싶은데...	6
그래? 뭐 간식 줄까?	7
부장님 오늘 뭐 드실래요?	7
야! 나 답답해 죽겠다.	0
야, 난 안 깨질 거거든? 말했지, 나 오빠랑 결혼할거라고.	6
결혼 5주년 기념으로 갔다 왔지. 좋더라. 너도 윤아 씨랑 한번 가 보면 맘에 들어할걸.	7
고무장갑 끼고 하면 되지. 걔도 참 꼴값이다.	6
혜민아. 오늘 할머니 친구들 만나고 들어오느라 늦게 들어올거 같은데 저녁 잘 챙겨 먹을 수 있어? 할머니가 가스렌지 위에 카레 해놨으니까 불 켜지 말고 좀 식었어도 그냥 먹어.	2
그래? 뭐니?	5
아이구 그리 멀리 가야돼?	6
네 손님.	7
내가 제형이랑 사이가 별로 안 좋아서…	1
올 때, 또 빈 손으로들 오겠어? 다 돈 봉투 챙겨오지.	1
윗집 할아버지.	0
난생 처음 본다는 말은 또 어디서 배웠대?	5
아- 아- 아	7
5백이요?  괜찮아요.        그 정도는 마련할 수 있을 것 같아요.	2
하이고.. 그래. 존댓말 써주는 것만으로도 고맙다고 해야 되나?	3
또 까먹은거에요?	6
이 자식이. 왜 가만히 있는 사람을 들었다 놨다야.  안 그래도 없는 눈썹털 확 다 뽑아버릴라.	0
보호요? 선택권을 박탈하는게 보호에요?	3
그래도 물 새는 벽이랑 장이랑 좀 떨어져 있어서 가구는 괜찮은 것 같아.	1
체육 시간 울렁증은 아니고?	6
안 하던 짓 하면 골로 가는거여.	6
아빠아~	4
언니, 오늘 왜 저녁 안 먹었어?	1
아냐, 아빠가 괜히 재밌어서 무서운 얘기를 한건데, 시골 가면 재밌는 일도 얼마나 많은데?	7
아 그게 뭔데. 관심 없어.	0
 김 과장님, 저 드디어 애 아빠 됐습니다!	7
여기 찾기 어려웠지.	7
 김주임님 커피 한 잔 드릴까요? 	1
나 보러 온건데?	7
와. 오랜만에 영화 진짜 재밌게 봤다. 엄마는 어땠어?	7
그래, 니 말이 맞다. 미안해.	0
그래. 그게 맞는 거 같다.	1
응! 그래서 지훈이랑 방학 내내 시골 가 있을 수 있어!	7
아… 사실, 지난번 여행은 엄마가 돈 대줬잖아.	2
버텨보자! 간단하면서도 핵심적인 인생의 진리를 짚어주신 것 같습니다.  좋은 말씀 정말 감사합니다.	7
근데 왜 아까부터 이모 이모 해요? 우리 이모 아니잖아요. 나는 이모 없는데.	6
예서가 결혼을 한다네.	1
아니 아빠 얼마 전에 안검하수 때문에 쌍커플 수술 했잖아.	2
아 내가 나중에 사줄게!	3
먹고 양치 했어 안했어?	3
생리가 뭔데?	6
 언제부터, 언제까지 가냐?	5
 어허. 하나	0
드라마.	6
살인마의 저택인데 당연히 시체가 있죠.	0
아버님, 수리 끝났습니다.	7
1억 3천이요.	0
왜 그래야 되는데.	3
아니. 너무 이상한게, 그 어디에도 거울이 없는거야.	2
아 내가 먼저 물어봤잖아.	0
그래?	5
아…	4
누군가랑 이 년정도를 만나면, 그 사람을 정말 알게 되는 느낌이 드는 것 같아.	7
여기 주변에 널린게 국화 꽃인데 뭐 비싼 차야. 거짓말 하고 있어.	3
쏟자 마자 바로 물기를 뻈는데… 안돼?	2
누나! 내 티셔츠 못 봤어, 혹시? 내가 빨래 하고 나서 거실에 놔뒀는데.. 없어졌어.	5
저 아저씨는 커피를 시키셨어요. 보이죠? 옆에 컵.	6
겁나 아파.	0
한시? 아 엄청 잤네.	5
어린 놈이 어디서 도끼눈을 떠?!	0
알겠어.	6
왜? 뭐 문제 있었어? 하긴,지금 우리 집이 좀 더럽긴 하지…	2
와… 너 진짜 나 홧병 나게 만드는구나..	0
아니 학생들이 듣잖아	3
우리 마누라가 뜨개질을 잘하잖아.	1
내가 맨날 말 할려고 했는데, 니 얼굴만 보면 깜빡 해버려.	4
어휴...	0
은수가 역시 똑부러져.  우리 현경이 때는 시댁 쪽에서 하도 우겨서, 스테이크 나오는 코스로 했잖아.	7
여자가 편지를 남겨놓고 간거에요. 자기 남편이 자기를 죽일거라고.	2
그러면 뭐해.. 근본적으로 해결이 안되는데. 진짜 환멸나.	4
음… 글쎄?	1
그렇게 심각해?	2
어 나도 15일. 같이 가면 되겠다.	5
네? 에이, 다 그러고 노는거죠. 저 다른애들이랑 세진이랑 특별하게 다르게 대한 적이 없는데요?	5
정말 죄송합니다…	2
내가 어린애지 어른이야? 됐고! 빨리 만들어 줘! 나 외동이라 외로워. 더 늦기 전에 동생 보고 싶어.	3
어. 요 앞에 새로 생긴 커피집. 거기서 파는 빙수가 그렇게 맛있대.	7
아니 생각해보면 내가 언니보다 훨씬 공부 잘 했잖아.	6
너 요즘 점점 말대꾸 한다? 언니한테 왜 그래?	0
그래서, 돈 주니까 아빠를 더 좋아하라는 거야?	5
알았어.  됐다. 삼촌 이제 호 불게.	7
응. 왜?	1
왜… 잠깐만 혼자 있으면 안될까? 형 화장실이 너무 급한데.	4
아이고….	6
목요일이면 분리수거 배출하는 날 아니야?	2
어휴 애들이 그걸 잘 지켜요?	3
아 그래서 꼬마가 외로웠나봐.	4
네. 뭐 정신없지만 어찌어찌 하고 있어요.	7
몸이 좀 상하면 좋겠어.. 나만 이렇게 쌩쌩하게 돌아다니고…	4
못 생기게 그릴거잖아!	0
왜? 아빠 죽어?	2
엄마가 집에서 쉰다고? 너 무슨 말을 그렇게 하니? 주말에 하루 종일 엄마랑 같이 있으면서 엄마가 얼마나 바쁘고 힘든지 못봤어?	0
도마뱀.	7
몰라.. 왜 자꾸 다시 물어봐…	0
알았어 할머니.	7
뭐, 시험에 붙어야 되니까. 그건 모르는 일이지. 근데 얼른 시험 붙고 결혼 하고싶다. 이 사람 아니면 안될 것 같아.	4
참치? 지금 참치가 떨어졌는데.. 다른건 다 돼요.	2
60을 넘긴 나이로 연기에 처음 도전하셨다는 이야기를 듣고,  저도 굉장히 놀랐는데요. 어떻게 이런 용기를 내셨는 지 궁금합니다.	7
하긴… 3년 끊은 헬스장… 30일도 안 나갔지…	1
그래도 싫어! 엄마는 바보야!	0
꼬맹이가 왠 한 숨을 그렇게 쉬어.	7
그러니까요. 괜히 병 키우지 마시고.. 대장내시경 한 번 해보세요.	2
아니. 너 이 학교 가려고 얼마나 노력했는데. 갑자기 그걸 그만둔다는 거야?	6
 아 물론이죠, 가슴에 영원히 묻을게요. 여기 표 값!	7
할애비 있을 때 주는 거지. 또 언제 주겠냐.	0
 네… 선생님은 어떤 방법을 추천하세요?	7
엥? 이게 뭐야?	5
이봐, 무슨 말을 그렇게 해?	0
그래. 친구 좋다는 게 뭐야. 나 오늘 무표정할거야. 	6
했어…	2
나랑 동현이랑 윤호랑 원신이랑 이렇게 넷이.	1
이제 한 500일쯤 됐어.	1
" 에휴. 아빠 힘내.	 아빠가 고른 걸 어쩌겠어."	4
뭐를요?	5
이게 어디 어른 앞에서 한숨을 쉬어?	0
 오빠!	4
세상에나… 화장실 이런데 가보지 그랬어.	2
와 진짜 대박이다. 그 쪽에서 연락 올 줄은 꿈에도 몰랐는데.	5
배웠어요?	1
왜 그래? 잠을 제대로 못 잤어?	4
"니 친구 지율이?  됐다.	 아빠한테 전화 좀 해줘.  삼촌 미끄럼틀 한번 더 타고 갈게."	4
당연하지... 우리 반 애들한테 다 물어보자.	1
그러니까요. 언니 선생님 연락처 있어요?	2
어린 녀석이 그렇게 눈을 부라리면 어쩔 거야? 니가 그렇게 행동하고 다닐수록 엄마 욕 먹이는 거 밖에 더 되니?	0
자기보다 어리다고 바로 반말하고 그러면 안되지.	3
휴.. 강인아. 그거는, 우리 집에서나 그렇게 할 수 있는 거고. 이렇게 공공장소에서는 그러면 안 돼.	0
왜요?	5
손님, 주민 등록증이 있어야, 입장하실 수 있다니까요?	2
 그래… 그럼 그렇게 해야지. 어쩌겠냐.	4
그래! 빠샤!	7
스타일은 어떻게 자르고 싶어요?	1
네 그래서 여기로 왔어요. 아무래도 언어는 스피킹이 중요해서 그것도 유지하면서, 아이가 문법 공부도 할 수 있었으면 좋겠어서요.        예전에 다니던 학원은 문법 수업이 아예 없었어서요.	6
"아.. 그거 말고도 너무 걱정되는 부분이 많아요.	 무조건 안된다고 하지말고, 한번 다시 생각해보세요 아빠."	2
잘하고 있다! 그래서, 오늘은 뭐 재밌는 일 없었어?	7
그랬나? 어우, 나는 비행기 꼬리 쪽에는 처음 타봤는데. 다시는 안하고 싶은 경험이었어.	2
나는 손이  여기까지 올라왔어. 진짜 낚아 챌 뻔 했잖아.	3
공대생들이 그래?	5
그래, 간만에 술도 한 잔 해야지. 그럼 그날 만나!	0
 출혈로 위험할 수 있었는데, 보호자 분이 잘 지혈해주신 상태로 내원해서 다행이었습니다.	7
시강 했는데 잘하던데? 어학원 경력이 있어서 그런가?	5
아 네. 죄송합니다.  새로 들어온 직원이 이제야 숙달이 되어서, 그간 실수가 좀 많았던 것 같습니다.	2
죄송합니다... 그게.. 제가 좀 덜렁거려서.	2
"	옥수수랑 김치요? 	고구마랑 김치는 먹어봤는데."	3
이게 무슨 상품이야? 다 뜯어져 가는 박스가.	0
그래? 그럼 용돈을 좀 올려줘야겠다. 얼마나 올려 주면 좋을까?	1
응. 너한테 2호점 내준대?	1
"어떻게 걱정을 안 하냐! 	너는 뭐 들은 거 없냐?"	4
 아씨. 이게 미쳤나.	0
문학인의 밤? 그걸 다시 할 모양이지?	5
비싼거…? 음.. 뭐 지난 번에 마신 자몽 셔벗? 주문해 줄까?	2
아 네, 저 지난 주에 6층으로 이사온 사람입니다.   앞으로 잘 부탁드리겠습니다.	7
너 다다음주에 모의고사 아니니? 시험 끝나고 가지?	0
과외 너무 어려워. 나는 못 하겠어.	2
음… 그럼 파스타?	5
결혼해야지! 노총각으로 혼자 늙어 죽고 싶어?	3
"저도 그렇긴 한데, 아이고.	아버지도 얼마나 고민이 많고 힘드셨겠어요."	4
그 사람들도 잘 몰라서 그렇지. 선인장도 물 너무 안 주면 말라 죽어.	6
와.. 아빠같이 꼼꼼한 사람이 가물가물하다고 하니까 너무 적응 안된다.	2
예~ 저 근데. 오늘 쓰시는 거 아니면~ 저도 괜찮은데	7
우와, 무슨 꿈인데?	7
그럼 너 집에는 어떻게 가려고?	1
아이고 착하기도 하지. 누가 이런걸 가르쳐줬대. 근데 어른이 줄 때는 그냥 받는 거야.	7
혹시 어떤 이유에서 이렇게 거절하시는지…?	0
그냥. 아빠가 재혼하는 거 싫어서. 그래서 반항하는 거야.        물론, 아빠한텐 1도 안 먹히지만.	4
너 알바하는데 가면 되지! 니가 알바하는데 찾아오지 말라고 해서, 한번도 못 가봤는데.	1
그럼 언니. 다들 그냥 입 딱 다물고 있는 거지, 속으론 할 말 많어.	6
정말? 정말 괜찮아 엄마?	5
아니요… 해 놓을 건데…	4
네. 제가 경고문도 대문짝 만하게 써 붙였는데도, 깡그리 무시하고 서리해간거 보니까… 만천하에 제 낯짝 드러나야 정신차릴 사람 같아요.	3
왜 헤어질 생각부터 해?	5
그럼 이제 제가 게임에 대해 설명해 드리겠습니다. 여러분은 김전일 일보 기자들입니다.	2
다음에 손주 한 번 꼭 보여 줘.	1
네. 알겠습니다.	4
 삐졌냐?	3
아, 아니에요. 아니에요.	5
또 깜빡 하신거에요?	6
너 데리고 놀이공원 가느라고 화장한 거잖아. 어제 놀이공원만 안 갔어도 얼굴 안 뒤집어졌을텐데.	0
그건 그때 가서 생각해 봐야지. 아무튼, 제발 소문으로 끝났으면 좋겠다. 제발.	6
 아니에요! 제가 찾을게요! 앉아 계세요!	2
너... 그 가게에서 커미션 받는거 아니지?	3
당분간 저 우울모드 들어갑네다.	4
"대신, 읽고 독후감 써서 아빠 보여줘야 돼. 그리고, 동화책은 안돼. 	 글로 된 책만 인정."	0
아니 발까지 샴푸가 있어야 돼? 그런 건 좀 사지마!	6
너 엄마 몰래 10만원 꿍쳐놨잖아. 그걸 벌써 다 썼어?	5
네! 유민이네 엄마가 스파게티 만들어줘서 그거 엄청 많이 먹었어요.	1
삼촌, 그렇게 말해봤자 하나도 안 무서워.	7
니가 돈 쓸 데가 어디있어. 뭐 해봤자 피씨방이니 노래방이니 그런 데 가느라 돈 다 쓸거면서. 그런데 쓸 돈으로 차라리 맛있는 거나 사먹지. 내가 너 그런 쓸데 없는 데 돈 쓰는 거 생각하면. 아유. 화딱지 나서 정말. 고모는 자꾸 왜 너한테 돈을 줘가지고 애가 쓸 데 없는 데 나돌아다니게 하는지 정말.	0
친구는 무슨. 소현이 걔가 어떻게 내 친구냐?	6
아니, 영재엄마 혼자 집에 있으려면 적적하지 않아요? 나도 그래서.	4
 이 가게 주인이 서비스로 줬어, 먹어 보라고.	1
너희 부모님 엄청 엄격하셨는데 너 디자인과 갔을 때 깜짝 놀라셨겠다. 	5
없는데.. 어른들은 여름에 공포영화를 본다며?	1
형님... 제발 한 번만 봐 주세요...	4
아 스트레스 받아. 나가나가.	6
네! 바로 앞에 있어요!	2
그럼 뭐 드리지. 아니면, 이제 여름이니까      휴대용 선풍기 사드릴까?	7
"그 반지를 생각하고 시나리오를 써서, 	다른 반지는 생각이 안나요. 할아버지한테 진짜 중요한 거 아는데, 	한 번만 빌려주세요. 	잘 간수하고 돌려 드릴게요."	6
아… 뭔가 오해가 있으셨던 거 같네요 고객님.	4
학교 숙제는 아니고, 그냥 제가 날려 보고 싶어서요.	1
그게 아니라, 할머니, 밥 왜 치우냐고.	0
왜?	5
엄마는 아들만 아니었으면 정말 백번도 더 갈라설 생각했을거야.	0
 지금은 없어요.	4
어쩔 수 없기는. 아무튼, 가서 튀김 만들어 둘 테니까 여기서 놀고 있어.	1
그래, 사람이 안 바뀌지. 그게 어디 가겠냐.	7
저도 민서 데려가려고 최선을 다하고 있어요.	0
엄마 생일.... 11월 18일 아니야?	6
그럼 새로운 사람 만난지 한 달 된거야?	5
"무슨 말을 하긴. 	 ‘송편 먹었냐?’ 그래."	2
좋아해 주셔서 감사해요. 동네 장사가, 단골 손님들 때문에 재밌는 거잖아요.	7
 어머. 그런 나쁜 말은 하면 안 돼.	5
거 일이 커지겠는데.	5
아직 그럴 계획은 없기는 한데.	2
10센티미터? 아니… 한 15센티미터는 되는 것 같아요.	1
아.. 그렇구나… 죄송해요.. 제가 갑자기 너무 무리한 부탁 드렸죠.	4
경주요.	2
 뭔가 허브향 같은 거 나는데?	5
뭐, 다른 일 하시는 거 있어요?	0
언니가 같이 좀 가줄래? 나 너무 힘들다 정말.	4
엄마. 그렇게 부르다 보면 그게, 환갑 잔치지 뭐야.	1
아니야. 너 더 있어.	0
 반쯤 키웠다고 쓸까?	7
근데, 여기서 이렇게 다른 가게 과자 먹어도 되는거야?	1
다음부터는 꼭 조심하세요?	6
내가 어처구니가 없으려니까… 야, 귀찮다 그냥 나가.	3
네. 엄마가 장어 먹으러 가자 그러시는 거 같던데.	2
그런 이유가 아니라, 빨간 경차를 몰 때는 온갖 걸로 빵빵거리고 시비걸던 인간들이, 큰 봉고차에는 아무도 시비를 안 걸더라고.	3
너 그 기자짓은 언제까지 해먹을래? 때려치고 내 밑에서 보좌관이나 하라니까.	6
왜?	4
회사 그만 둔 이후로 하루하루가 전쟁이야. 둘이 먹고 살기도 벅찬데 이 상황에서 애를 어떻게 낳겠어.	6
너	7
죄송합니다. 정말 죄송합니다.	2
엄마는 어떻게 아빠랑 결혼했대..	3
 내가 1에서 10페이지까지 발제할게,    니가 11에서 21까지 발제 해.	1
그쵸?	7
무슨 소리야. 그냥 돈만 받고 보내줄거야.	3
저기요.	2
아하… 그래? 그럼… 뭐 끊어야겠구만.	4
내가 할 수 있을까?	4
응.. 그냥 복도에서 얘기만 하더라 근데 그래도 그러면 안되지!	3
뭐라고 할려고 물어보는 거 아니야.	6
현수네 동생 보니까, 애기 너무 귀여워.       나도 애기 옷도 입혀주고 싶고, 맘마도 먹여주고 싶어.       그리고 애기가 잘 때 너무 귀여워. 사진도 찍고 싶어.	7
네에. 무슨일이세요?	5
너는 사랑 해봤니?	3
나? 당연하지. 아직도 가끔 우리 어머니 꿈에 나온다.	4
그래서 치료 하느라 잠깐 쉬었던 거야.	2
뭐어? 원래 남자는 일 안 하는거야.	6
그 물수건이 열을 빼 주듯이, 땀도 똑 같은 일을 하는 거야.	1
아, 엄마 저번에 할아버지 팔순잔치 때 왔던… 커다란 뿔테안경 쓴 사람 있잖아..자꾸 자기네 가게에서 물건 사라고 했던 사람.. 그 사람 누구야?	1
예. 제가 정신이 없어서 실수했나보네요. 죄송합니다.	4
아니 무슨 배우 하나가…. 스케쥴을 지 맘대로 이리 끼워 넣었다, 저리 끼워 넣었다~ 아주 대선배님 납셨어~	6
내가 요한이가, 눈에 밟혀서 그래.        이거라도 받아줘.	4
머슴? 너 지금 머슴이랬어?	5
저기요.	0
그런 거 함부로 하면 다치는데.	2
…… 희천이가 죽었다네.	4
나 수학자 안 할 건데?	3
그러게 기분 참 묘하네. 언제 옮길까?	4
"응! 중학교 때는 설화 오빠들 사생이었고,	 고등학교 땐 동방명주 오빠들.  대학생 땐 전남친들 따라 다니느라 사생할 시간이 없어서.."	7
왜 한숨 쉬어?	5
엄마 아빠한테 얘기해봐.	1
네. 멀리 간 건 아니고 옆 동네예요. 일이 있어서 잠깐 이 동네 들렀다가, 여기 커피 마시고 싶어서 왔어요.	7
어. 왜 그래?	5
어. 나 노가다 나가려구.	4
네.. 근데 김대리님이 또 이대리님이 먼저 시켰으면 이대리님꺼부터 해야지 왜 그랬냐고 하셔서..	4
그 정도라고..?	5
명숙이 아줌마? 와 명숙이 아줌마 진짜 오랜만이다. 아줌마 잘 지내셔?	5
만나는 사람도 없고?	2
공부 열심히 해서 로스쿨 가면 되지.	7
무섭긴 무서웠는데, 그 사람 말하는 투가 완전 전형적인 사이비 수법이더라고. 그래서 계속 같이 있었어.	2
안 되겠네. 그럼 잠깐 경찰서로 갑시다.	3
학교 사회시간에 요즘 결혼을 안하는게 추세다. 특히 여자들이 결혼을 안한다. 이런 얘기 배웠는데, 나는 결혼하면 안 외롭고 좋을 것 같은데 왜 요즘 사람들은 결혼을 안하나 싶어서.	4
아니 아무리 그래도 내 탓은 아니라니까?	6
미국도… 맛있는 음식은 많지. 그런데 너무 비싸. 한국처럼 저렴한 가격에 다양한 식재료를 푸짐하게 먹을 수 있는 곳은 정말 없어.	4
그래, 내가 그래서 말을 못해.	1
어? 싫어?	3
갑자기가 아니야, 너. 오늘도 아침에 아빠 혈변 봤어.	2
와. 너 진짜 천재다.	5
 한 잔 받으시죠 장인어른.	4
에이 또 어떻게 그래. 잠깐 장 좀 봐 와야겠네.	0
그 신문사 건물?	1
혹시 아버님이 술 취하시면 폭력을 쓰시니...?	2
근데 생선 먹기 싫어. 생각만해도 비려.	3
사모님, 저 이렇게 나이도 어리고. 집안도 가난하고.       기사일 해서, 힘들게 살고 있는거. 사모님도 아시잖아요?       제 형편에, 그런 외제차 수리비를 어떻게 감당하라고….	4
술은 박씨가 마셨는데. 왜 욕은 내가 먹는 거야…?	0
어지러워?	3
응 세리 이번에 완전 이 갈고 공부했잖아. 4.3 만점일걸?	1
내가 많이 도와줄게.	4
제 아버지는 따로 있어요...!	0
그 한 달 어제까지였단 말이야.	7
그럼 월요일에 입지는 못하겠네요...	4
진짜 짜증나.	0
저 근데 현수랑 그렇게 안친해요.	7
물렸어??? 어디 물렸어.	5
결혼할 사람이 있어야 결혼하지. 강인이 너 여자친구도 없잖아.	5
 한국지리?  고삐리 주제에 싸가지를 어디다 밥 말아 먹었나. 야 너 잠깐 나와봐. 후. 	0
아니야… 핑계는 무슨… 다 내가 머리가 나빠서 이렇게 된건데…	3
승우야, 넌 이 회사 다닐 만하냐?	6
"저 지금 나가야 되는데. 	약속 있어요."	6
그러냐?	2
어떻게 알아, 아빠만 사랑한 걸 수도 있잖아. 엄마한테도 물어봤어?	5
저기 아파트 앞에. 2층에 있는 학원.	6
못 참겠으니까. 그러지…	4
내가 언제 막말을 했어?!	0
그러게. 우리가 그 강아지에게 어떤 힘이 되어 줄 수는 없는 걸까?	4
아줌마야말로 저한테 막 반말하고 계시잖아요!	3
아, 엄마 어디 갔어?	5
"평일 날은 3일 정도 가고, 	뭐 주말에는 갈 때도 있고, 안 갈 때도 있고."	6
어떻게 가야 돼요? 길 좀 알려주세요..	4
1년 정도.. 된것 같은데 아직 약정이 안 끝나서요.	4
아무튼 증거가 없어서, 저희는 인정 못 하겠네요. 죄송합니다.	3
아이고, 전혀 문제 없습니다.	5
제발 한번만 봐주세요… 저 진짜 아빠한테 맞아 죽어요…	4
소정이? 그 때 우리집에 놀러왔던 그 친구잖아.	5
네 부탁드려요.	2
많이는 아니야.	2
먹어보고 싶다.	1
�� �ű� ����.. �� �� �� �ƴ���?	1
말씀도 참. 아직 식사 안하셨죠? 오시면 드신다고 하셔서 저도 그냥 왔거든요? 과일이라도 깎아 올까요?	7
앞이 꽉 막힌거지…	4
발레? 갑자기 웬 발레?	5
연희가? 뭐라 그랬길래 뜸을 들여.. 뭔데! 그래, 말해봐.	2
개판이라니. 올랐는데.	6
아부지. 화투가 치매에 그렇게 좋대. 그거 좋은 거야.	2
"어후... 너 대체 몇 호니.		 1503호니?"	6
아빠 우리 그거 하면 안돼? 응? 제발..	2
알게된 사람 누군데? 누가 소개시켜준 사람이야?	0
절기가 총 몇 개야?	1
에이, 그렇게 말을 하니까 놀랬잖아. 엄살 피우는 것도 아니고 뭐야.	0
웃긴 여자? 야 이 도둑놈아.	5
별것도 아닌 걸로 왜 그래?	1
아~ 선생님 같은 사람이 우리 엄마였으면 좋겠어요.	4
지영이 언니? 어제 내가 전화했었는데. 거짓말 좀 치지 마. 어디서 잤어.	0
"그렇잖아. 무슨 꿈이 있어서, 서울로 올라온 것도 아니고, 	와서 맨날 그냥 영화만 보고."	3
아이고 나는 어렸을 때 녹용 한 번 잘못 먹고 살 찐 이후로 녹용은 잘 못 먹겠더라구요.	6
그럼 사진 보여줘봐.	5
알았어요 알았어. 그럼 음악 줄일테니까, 그쪽도 과일 쓰레기 조심하세요.	6
그럼 나가서 취직을 하면 되겠네.	6
"그게 무슨 욕이야.	 사전 찾아봐. 사투리라고 나오지."	3
 야. 에어컨 켜라.	0
하… 몰라. 기억도 안 나..	3
아 뒷자리에 아이가 있었어요.	2
가만히 있긴 어디다 대고 동생 타령이냐고 욕을 막 퍼부었지.	4
그걸 차면 뭐가 좋은데?	6
 선생님!!!!	2
제가 엄마 닮았어요? 사람들은 아빠 닮았다던데.	5
"그럼 다 괜찮아. 뭔데? 	혹시... 돈 필요해?"	2
몰라. 거기가 다 살기 좋단다.	6
너야?	0
하긴, 할아버지는 그렇겠지.	5
받아들여…? 내가 교사 생활 15년 하면서 그런 소리하는 애는 니가 처음이다!	3
말도 안돼. 뭐가 기분이 나쁘다는 거야.	3
그렇게 안 느껴져.	0
그럼. 비싼 미국 과자도 있단다. 너 미국 과자 먹어봤니?	7
약속된 시간에 잔금을 못 치뤘잖아.	6
아니 중국어가 싫은 건 아니고, 선생님이 싫어.	4
민수는 진짜 어릴 때부터 태권도를 배웠잖아. 어릴 때부터 꾸준히 했으니까 너보다 빨리 딴거지. 그게 뭐가 문제야?	3
네. 자동차 게임 하는 것처럼 재밌어 보였어요!	1
병원에서 뭐래? 당은 좀 좋아졌대?	1
뭐? 너 소영이랑 결혼하기로 한 거야?	5
너 이제 26살이면 어린 나이 아니다. 알아서 잘 살아야지.	5
그 남자 얘기를 해 보라니까 왜 내 얘기를 시작하지 갑자기?	1
네. 그건 좋은 습관이세요. 근데, 그럼 왜 가슴이 답답하시지..	6
 네?	5
할머니 솔직히 엄마의 요리에 대해서 어떻게 생각해?	6
버스 정류장에서 왔지.	1
공포 영화를 보면 왜 시원해져?	1
소박하긴. 너도 나중에 딸 낳아서 그 딸이 밥해준다고 생각해봐라.	6
법원에서 왔네요..	7
아빠. 언니한테 전화 왔어.	4
동물을 죽이면서 노는게 정상이냐고! 지금 할아버지가 그거 묻는거잖아.	0
헐…. 삼촌 감옥도 갔어?	3
 여기서 얘기하세요!	0
응. 안 줄래. 담임한테 뭐 해주고 싶지가 않아.	6
아빠는 자신감이 지나쳐서 탈이야.	3
뭐… 이번에는 좋을 것 같아.	7
이열~ 짜식 그래도 멋있다 야. 웹드라마라니.	4
아직 잘 모르겠어. 미국이나 유럽 생각중이야.	4
어. 요즘은 사진이랑 동영상까지 같이해서 보기 편하더라구.	7
원래 먹는 걸로 지어야 오래 사는 거야.         찹쌀이 맵쌀이 이렇게도 짓는데.	7
그렇죠...	2
당신 책임이 왜 없어? 아무 문제 없다고 해놓고 팔았으면, 사기 친 거 아니야?	0
엄마가 학교에 전화해줄까? 아침에 세탁소 열면 찾아다 바로 갖다줄게.	2
음… 누나에 비해서?	3
아…. 나 어떡하지….	4
뭐가?	6
 가족끼리 잘해야 돼. 서로.	3
생전 안 하다니 내가 언제? 걱정 붙들어 매고 기다려.	6
베란다 철봉에? 아유, 그럼 가방 밑으로 떨어져. 위험해. 엄마 안 계시니?	5
그거는 우리 가족이 같이 모은 거란 말이야.	4
요 앞에 새로운 콩나물 해장국 집 가보셨어요? 달걀도 안 비리고 아주 맛있는데.	7
너도? 너는 벌써 그래서 어쩔라고 그래.	6
맞어. 그래서 맛이 없나봐.	7
저 시계가 아마 AAA사이즈 4개 들어갔던 것 같은데. 내가 한 번 확인해 볼게.	7
싫어요! 제가 왜 죽어요!	0
그럼 걍 육군 가. 말년엔 하루하루가 금쪽같다.	5
빨래는 오실 때마다 돌려주세요. 여기 세탁기 있고 빨래 바구니는 옆에다가 갖다 놓을게요.	1
"안돼. 그 장비 살 돈이면 영어 학원 가는 게 낫지. 	 변덕 부려서 금방 또 그만둘 거 빤히 보인다.  장비들 먼지 속에 파묻힐 거 안 봐도 비디오고."	6
 아…진짜….또 거짓말 쳤어.	6
아빠가 엄마를 힘들게 한 거 아니면 뭐야. 아빠는 진짜 나쁜 사람이야. 요즘 집에 들어오지도 않고, 엄마가 이렇게 힘든지도 모르지?	4
아고. 집에만 그러는 줄 았았더니  유치원에서도 있는 성깔 없는 성깔 다 부리고 있는가보네요.	7
그래도, 위험하지 않나?	6
일가족이 다 같이 사는 커다란 저택이 있는데,	1
코인노래방이 여기저기 우후죽순 생긴 후로 손님이 확 줄어서 말이지.	4
응.	5
싸운 거 아니야.	4
아니 너 왜, 왜 화난거야?	2
그러게… 우리 대학 동기들은 정기적으로 만나는 사람이 몇 없는데.	4
형도 약육강식이 뭔지는 알지… 그런데 지훈이가 키우던 사슴벌레는 자연 속에 있는게 아니라 지훈이 통제아래 있었던 거잖아. 지훈이가 먹이로 새한테 안 줬으면 안 죽었을 텐데… 이건 약육강식이 아니잖아.	4
엄마가 꼭 말은 그렇게 해도.. 성대한 걸 원하던데..	3
패션푸르트가 무슨 맛이지?	5
당신이나 똑바로 하세요.. 당신이나!	0
나한테 겁주던 그 놈 생각하면 치가 떨린다니까...	0
그런 복 받은 적 없구요.. 우리 엄마 어딨냐니까요?	3
너는 아빠 닮아서 안돼. 그리고 너 피아노 배우고 싶다고 보내줬지.  근데 두 달하고 그만뒀지. 수영 보내줬더니 일주일 하고 그만뒀지. 발레는 토슈즈며 무슨 드레스며, 돈이 얼마나 많이 드는데 그걸 덜컥 시작해.	6
본명으로 적어야 하나요?	2
감사합니다.	7
뭐? 이게 보자보자하니까, 내가 만만해?	0
얘는 왜 이렇게 우리 영감을 못 잡아 먹어서 안달이야. 당장 보도자료 준비하고 의원님 지금 어디계셔?	6
부지런한 사람들은 잘 맞는 모양이야. 그제부터는 벌레들 하고 전쟁한다고, 온갖 걸 사왔더라고.	1
네! 영업계의 최강창민이 될 이창민이라고 합니다. 반짝이는 건치와 밝은 미소로 고객들의 마음을 뒤흔들겠습니다!	1
삼촌 그러다가 금방 노총각 돼.	3
어디서 소리 소리를 지르세요? 그만두지 못해?	0
공짜로 준다고?	5
커피요? 저는 콩나물 사야 하는데… 엄마가 콩나물 사오라고 했어요.	5
아니야. 내가 너보다 훨씬 공부 잘했어 혜진아.	0
" 이걸 어떻게 하나… 	엄마가 형준이 엄마한테 전화를 해야하나?"	2
아주머니가 왜 걱정을 해요? 길고양이를?	5
맛있더라?	5
너도 내 아들이지.. 소중한 내 아들이야..	4
왜 그래 진짜. 배고파 죽겠는데 사람 붙잡아놓고.	0
" 아니.. 분명히 1층에서까지 반지가 있었는데...	 분명히 주머니에 넣었는데... 없어요."	2
아 참내… 보자보자하니까.	0
뭐 그 다음에 또 생각나시는게 있으신가요?	6
 너 지금 하루 종일 게임만 하고 있는거 알아?  잠깐 멈추고 이것 좀 봐주면 되잖아. 엄마 지금 이거 답장 해줘야 되서 급해.	0
네. 어떻게 하면 돼요?	7
나 요즘 허리가 너무 아파.	2
삼촌, 나랑 핸드폰 바꿀래.	2
아부해도 안돼.	6
그게 무슨 말이야?	5
저도 그랬는데, 엄마가 가방에 넣어줬어요.	7
아. 네.	7
그럼. 당연하지.	7
그러게. 고모부는 도대체 왜 그럴까?	3
네. 아직까지는 뭐가 뭔지 잘 모르겠어요.       근데 제가 장이 워낙 안 좋아서, 그게 힘들어요.	2
하… 저희가 잘못 했구요… 근데 너무 말씀이 심하신거 같아서…	2
…. 당연하죠	6
"나도 알아. 아니까 쎄한 거라고.	 너도 그 언니 봤었어?"	2
로봇 청소기가 못 하는건 이렇게 먼지털이로 털어 줘야지.	3
에이, 치사 빤스같으니.	3
네. 정말 그런 것 같아요. 이사오면서 수리하느라 시끄러웠을 텐데도 다들 너무 친절히 대해주세요.	7
와 은혜를 이렇게 갚냐?	0
이따가 마트에 장 좀 보러가야겠어. 같이 가자, 여보.	2
봐라봐라. 너는 이미 글렀다.	6
아직 괜찮으신 나이세요. 임신 기간 동안 관리만 조금 조심히 해              주시면 문제없으실 거예요.	1
뭐야. 뭐 마음에 안 드는 게 있으면 말을 하면 되지.	6
사람이 먹는 음식은 염도가 높아서 강아지 주면 안된다고요!	0
이 동네에서는 그 정도 금액으로는 아파트 구하기가 힘든데.	2
그래, 그러니까 사람들이 다 이거 먹으려고 줄을 이만큼 늘어서 있는 거 너 아까 지나 오면서 못 봤어? 봤잖아.	5
착실하게 치료 잘 받아야지.	4
 요 만한 캡슐이 있어서. 그걸 넣고 버튼만 누르면 커피가 나온다니까.	1
그렇지는 않지.	1
왜냐하면 니 방을 보면 드는 생각이 하나밖에 없으니까.	3
아 요즘 뱃 속이 답답하고 소화가 잘 안돼요.	2
맞아. 완전 습관 됐어. 늦게 자는게.	1
내가 왜 너네 엄마야?	0
무안하게 하려던건 아닌데… 죄송합니다.	2
"그래. 몸이 찌뿌둥해서 못 살겠다.	 알바라도 해야지."	6
아.. 여길 혼자서 다 하세요?	5
 아빠가, 이번 주 주말에 다같이 캠핑 갈 거래!	7
날 보니까 생각난 보험이 대체 뭔데?	3
응.	6
명우…? 누구야 그게…	5
여기 이렇게 사람 붐비는 거 보니까… 상대적 박탈감 든다. 불경기, 불경기 하는 와중에도… 이렇게 사람이 많다니!	4
결혼하고는 그랬지. 나는 어릴 때처럼 그냥 시골에서 소 키우고 닭 키우고 자연 속에서 살고 싶어.	1
안되면? 어쩔건데. 니가 지금 내 머리에 한 짓을 봐.	3
그 전까지라도 맛있는거 사 많이 먹이고 좋은 추억 만들어 주자.	4
엄마가? 우와…. 진짜 배신감 든다.	0
근데 걔가 학원에서 딴 여자애랑 얘기하고 있는거야!	6
마을회관 같은 곳 빌리고, 음식을 제대로 하는 건 어때?	5
알았어요. 한 번 줘 봐요.	7
저 종점까지 가는데요, 무슨 일이신데요?	5
너 지금 엄마 요리 평가하냐?	3
응 감자가 맛있어서 맛있대!	7
얘는. 아무리 그래도 아빠를 못 믿니?	0
언니, 나 어떻게 해야돼?	4
아, 맞다! 오늘 드라마 10시 15분에 시작한다고 했단 말이야.	0
 예예~	6
 사진도 찍고 싶어요...	7
응. 꼭 유기견으로 데려와야겠어.	1
좋아서 그러지.	1
난 이미 글렀어. 지금도 말 못되게 한다고 엄마가 맨날 뭐라고 그래.	6
그게 무슨 말도 안되는 소리야. 지금 니 나이에 공부하고 키크고 해야 할 일이 얼마나 많은데… 고작 살을 빼겠다고 탄수화물을 제한해?	0
그걸 내가 어떻게 알아?	0
형님.. 그게 무슨 말이에요. 상철이 얘기가 갑자기 왜 나와요?	2
아니 아니.. 나한테는 아무 것도 안 했어 괜찮아 엄마	5
"	넵. 보냈어요."	7
그 쪽 세탁물 안에 있던 곰돌이 그려진 티셔츠, 그거 저번에도 세탁기에 처박혀 있던 거 제가 똑똑히 기억하거든요.	3
진짜라니까?	0
예. 여기가 제 방이에요. 뭐 필요하세요? 목마르세요?	5
" 전 진짜 이해가 안 돼요.        	왜 좋아하는데 괴롭혀요?         	전 제가 좋아하는 콩이 안 괴롭히고 맨날 다정하게 쓰다듬어 주는데."	6
너는 애가 좀 못됐다. 그거 알지?	0
와. 봐봐요.	5
아 그래도, 장학금 언제 끊길지 누가 알아요~ 받아요.	4
아니 이번엔 카페 모카 시켰어.	1
왜 죽였어?	0
 하…  아직까진 그렇겠지. 나 소송할거야. 해서 니 동전지갑까지 털어 먹을 거야.	3
그래서 이렇게 자네를 부른 거 아닌가.	3
왜요?	6
선생님이 화나면 애들보고 나오라고 해서 서로 꼬집으라고 하셔.	6
어? 모르는데.	3
네.	7
연예인? ...누구?	5
할아버지 같은 사람!  자기 하고싶은 대로만 하는 악마!	0
어? 톡 프로필에 여자친구랑 같이 찍은 사진 아니에요?	5
모르지. 그래도 로또를 사야 당첨이 되지~ 당신 로또 요즘 사?	1
아 그래서 직원가로 싸게 샀구나?	5
내가 뭘 다해. 큰엄마랑 작은엄마랑 다 계신대.	0
너 몰라?	5
합성 아니래도. 야, 너는 어떻게 영상을 합성하냐?	3
오호…기선을 제압하시겠다? 그럼 저도 오늘 봐드리지 않고 전력으로 임하겠습니다.	7
손님, 그건 알 덴테 조리법이어서 그렇습니다.	2
저, 다음 달 열리는 일본 가정식반이요, 아직 마감 안 했죠?	7
나도 뭐 그냥 비슷비슷하지 뭐. 근데 이제 슬슬 압박이 좀 들어온다.	2
저거 어떤거요? 담배 드릴까요?	2
작년에? 운행을 많이 안 하셨나봐요.	5
"술 취해서 그래요. 	 술 깨면, 자기가 자기 얼굴 막 때리고 그랬어요."	6
그래? 무슨 숙제인데 그래?	1
하아… 참...	0
호텔이랑 렌트카 전부 예약했어.	1
응.	7
아니요. 평생 몰라도 좋아요… 평생…	0
그건 그래...	6
아침에? 씨리얼에 우유 말아서, 계란후라이 하나, 복숭아 세 개, 토스트 세 조각 먹고, 조금 이따가 계란후라이 남은 거에 밥 비벼서 한 공기 먹고… 아니 그건 점심인가?	5
그 때 당시에도 좋았어?	5
응. 지금 한 번 더 봐야되겠다.	6
28만원이야.	1
엄마가 지금 여기 계셨으면 더 심한 얘기도 하셨을 거에요.	0
음… 아구찜 어때? 나 매콤한 게 땡겨.	7
참... 답답하다...	1
뭘 다 커 니가. 아직 핏덩이같은데.	6
나도. 근데 진짜 이쁘다.         여기 있으니까, 무슨 드라마 주인공 된 것 같애.         왠지 갑자기 자객이 튀어나올 것 같고.	7
바퀴벌레에? 없어 없어. 요즘 세상에 바퀴벌레 있는 집이 어딨어.	3
그래. 선생님이 보니까, 지은이 네가 글 쓰는데 소질이 있더라고.	1
미친. 공부나 해.	3
나두 그랬어. 남들 다 하는 걸 못해드린게...	4
"기차 예약 했어요? 	사람 엄청 많을텐데."	6
그래라. 이거 별로 비싸지도 않아. 근데 넌 너무 어려서 안 사주실듯.	5
그래도. 안돼. 아가씨는 알 거 아니야? 내 원래 비밀번호. 그걸 알려줘.	3
그래서 괜찮아.	1
참네. 쥐띠라고 부지런한가?	3
별일이 있었던 건 아닌데, 우리 마누라가 그냥.. 그만 살고 싶다는 거야.	4
형들도 지금 만족 중인 거 같던데. 어떡할꺼?	2
벌써 돌아갔지. 10년인가 됐어.	4
오~ 밝아서 괜찮다 이거지?	7
전 부인이랑은 왜 헤어졌대?	1
그런데 이번에는 대흥이 아저씨가 출전하세요?	5
네. 그래서 거의 울면서 콩국수 한 젓가락 먹었다가...	3
갈 때 배터리 빼놔야 겠다.	1
강인이 너, 태권도 배우지. 거기서 사범님이 안 가르쳐줬어?	5
아니.. 여기 설렁탕이 아무리 유명하면 뭐해, 내가 이제 질렸다구.	0
그랬겠다 진짜.. 너무 무서울 것 같아.	2
알았어. 그러면 과자 딱 한 봉지만 허락해줄게.	7
의사면 뭐해? 제 짝하나 못 찾는 푼순데.	3
급식을 받아놓고 다 버려?? 왜 점심을 안 먹어?	6
그런데 왜요?	2
나도 하는데, 자네가 못 할 게 뭐 있어?	1
 수고했다. 수고했어.	7
 삼촌! 나한테 뭐 할 말 없어?	0
무섭게 왜 그래요…	4
그래. 남매관계인 사람은, 형제관계라 보는 거지.	1
"그러시면 딱 이 제품을 드셔야 되요. 원래는 이 제품이 서울 시내 유명 대학병원, 백화점 명품관에서만 판매되던 제품인데 이번에 어버이 날을 맞아서 저희 회사가	 특별히 어르신들이 쉽고 부담없이 드시고 건강 찾으실 수 있게 70%할인가로 드리고 있어요."	5
 일한거 아니지.	3
그래. 너 아니면 누가 있어?	0
야 야. 됐다. 됐어. 말을 말자.	3
네. 죄송해요 선생님.	2
좋지요.	7
아니 얘는 지금 누구 편을 드는 거야?	0
뭐…? 누구? 회사가?	3
우리 엄마가 원래 밥 주던 고양이가 있는데 걔가 눈이랑 다리를 다쳐서 우리가 입원을 시켰거든. 이제 퇴원을 하려고 하는데 다시 길로 보내기엔 너무 불안하고… 근데 우리 집엔 고양이가 다섯 마리나 있으니까 더 이상 업어올 수가 없어서…	2
네 진짜 맛있어요. 짬뽕도 맛있고, 다른 것도 맛있고.	7
"그치? 항상 괄호가 있으면 괄호 안에 있는 거 	먼저 처리해야 된다고 그랬지?"	3
근데 이거, 커피 맛이 왜 이래요?	6
짠! 놀이공원 티켓이다! 이거 자유이용권 아빠 회사로 나온건데, 아빠가 사람들이랑 가위바위보 해서 이겨서 가져온거야. 잘했지?	7
팀장님이 퍽이나 그렇게 해 주시겠네요.	3
어. 근데 뭔 일이래?	5
" 아 정말요.  그놈의 시키 집에선 원체 무뚝뚝해서, 통 말을 안해요.	 아이고. 어쩌지. 학생회장이면 반에 뭐 간식이라도 돌려야 하는 거 아닌가요?"	6
오 김수한이. 나이스. 얘 요즘 홈런 많이 치더라?	7
뭐라고 이놈의 시키야. 너처럼 천하태평한 초등학생이 어딨다고,  스트레스 핑계를 대셔. 엄마 말처럼 일찍 자고 일찍 일어나고, 밥만 잘 먹어봐. 잭과 콩나무처럼 쑥쑥 자랄 걸.	0
너희 엄마랑 어떻게 만났는지 얘길 안 했던가?	5
할아버지도 제가 꼭 결혼을 해야 한다고 생각하세요?	2
왜? 우리 앞으로 같이 지내려면 친해지는 게 좋지 않아?	7
몸 안 쪽에 ?	5
정 필요하면, 오빠한테 도와 달라고 해. ...서른 전까지는…	1
뭐? 이놈 봐라… 지가 뀌고, 민망하니까 생사람 잡네.	0
내가 너무했다고? 됐다. 말을 말자.	0
다 끝났니?	0
그럼. 이제 어른이지.	5
이 양반이 나한테는 연락을 안 하고. 어제 고기 구워 먹는다고, 집에서 밥 먹으라고 했을 때는 알겠다고 하더니.	0
아이고, 고생이네. 밥은 제대로 먹고 다녀요?	4
그건… 내가 아빠가 얼마나 위대한 남잔지 몰랐을 때의 생각이고. 지금은 그렇게 생각 안해. 나… 깨우쳤어.	1
그 집은 도배만큼은 확실히 됐겠어요.	1
그래요? 형님 드신지 얼마나 되셨어요?	5
근데 이건 너무, 춥지 않니? 온도를 좀 낮춰.	2
요즘에는 소송가요 사장님.	0
형 근데. 지금 보내줄 수 있어? 내가 좀… 급해서.	2
나를 뭘로 보고 그런 말을 해? 나, 축구장까지 가서 봤다고.	0
어. 환청이나 환각을 느끼다가, 뛰어내리는 사람이 많았대, 그 약을 먹고.    혹시, 보민이도 그 약을 먹은 게 아닐까...?	4
좋은 게 좋은거지. 학생이 왜 이렇게 까다로워?	3
김교수도 이번에 영국 가?	2
언니는 요새도 남양주로 출 퇴근해?	1
지수야. 지수는 아빠가 좋아, 엄마가 좋아?	4
너는 내가 좀비 되면 어떻게 할건데?	5
너무 머니까… KTX로 출근하는 거 너무 힘들어..	3
응? 왜? 나 오늘 약속 있는데.	6
"아...농수산물 시장 가면 	 다섯 시간은 걸리는 게, 그거 때문이구나. 	 난 농수산물 시장이 엄청 큰 줄 알았는데.."	2
밀려 쓰기는. 그냥 너의 현실을 직시해라 아들아. 그냥 넌 공부를 안 한 거야.	3
일부러 그런 게 아니야? 너 정말 오늘 나한테 먼지나게 맞아 볼래?	3
특강이 있어서, 학원비를 추가로 좀 더 내야한대요. 정규 수업처럼 보충수업이 있어서.. 학원비가 두배라고 그랬거든요.	2
요리해 주시면 되잖아요!	0
야 너는 북어 만난지 얼마 안 됐잖아.	3
걸어다니는 죽음.	1
그래 너 마셔. 이상한 놈 보겠네.	3
말해 봐. 니가 친구한테 뭐라고 해서 울었는지, 니 입으로 다시 말해봐.	0
멀기는. 그리고 매니저가 태워다주는데 뭘.	7
치사해! 진짜. 오빠 바보멍청이!	3
왜요?	1
형.. 나 이제 더 이상 못 하겠어.	4
안 아프긴 뭐가 안 아파요! 엄청 아프다고요!	0
 너 연애 하는구나.	3
"형은 아직 어른 아니야. 	 형같은 사람을 애어른이라고 하는 거야. 아니면 어른애기."	3
대박. 너 말 진짜 잘한다. 괜히 전교 3등이 아니었구만?	7
너, 피부가 어쩜 이렇게 곱니.	7
어, 요즘 돌잡이 할 때는 별의별 것들을 다 놓더라구.	1
탄탄한 직업 있는 애가 왜 죽는 소리야?	0
 거기서 뭐하는데?	3
내가 개발한 꽃차야.	7
그냥… 내가 좀 좋아했었어. 걔를.         아… 내가 별 말을 다 하네.	7
그 분이 내 롤모델이야. 나도 그 분이랑 꼭 같이 영화를 찍어 보고 싶어.	7
영화에서 봤는데. 하늘을 막 날아다녀요.	5
그게 아니잖아.. 나 진짜 귀신 무서워 한단 말이야.	2
"그러니까 보톡스 맞기 싫으시면 찡그리지 말고 	많이 많이 웃으시라구요."	6
병 난다? 너 내가 아버지로서 하는 말이야.	2
그럼, 나는 36개월 꼬박 채워서 삼년 있었는데...	0
"그래. 잔뜩 먹어. 	 준호 뽕 뽑아야 된다?"	6
갑자기 이제 와서 그 얘기를 왜 해?	6
민지 입니다, 김민지요. 내일쯤 같이 방문하겠습니다.	7
어휴. 이래서 자식 키워봤자 아무짝에도 쓸모 없다니까 그냥. 	4
이거 니 꺼 아니야.	3
아 그거랑 달라. 그냥 속이 좀 쓰린거야.	4
그럼 수리 기사님 언제 오시는데요?	1
전에 다니던 학교에서 연애는 해 봤어?	4
아이 참. 드리면 좀 좋게 받아요.	0
그렇게 오래됐냐? 나는 이제 늙어가지고 시간이 지나는 것을 잘 모르겠어.	4
젊은애들 왜? 젊은 애들이 커피를 많이 좋아해?	5
뭐라고? 너 내가 너한테 잔소리하느라 얼마나 힘든 줄 알아?	0
착한 귀신인지 나쁜 귀신인지.	3
학교는 맞는데, 더는 진짜 말씀 못 드려요. 죄송해요.	2
짱이다.	1
아이, 비결 있잖아요. 혼자만 아시지 말고. 저도 알려주세요.        저도 30대 들어서고 부터는, 피부가 예전 같지가 않아서.	4
그건 그냥 돼진거지.	3
듣고 말고 할 게 어딨어요? 그냥 세례 받지 말라는 거잖아요.	3
그래. 그럼 그러자. 내일은 저녁 약속 없어?	7
손주를 처음 딱 보는데, 그 기분은 말로 설명을 못 해요.	5
조 과장님, 아직 퇴근 안 하셨네요?	5
내가 물어본거 먼저 말해줘.	4
이강인, 너 이 녀석, 오늘 도서관 가기로 했잖아, 얼른 챙겨서 나가자, 이 녀석아.	0
우리 집에 남은거 조금 있으니까, 일단 그걸 써보자.	1
누나 나 정도면 잘생긴거야?	5
아 버스정류장에서 왼쪽 길 말고 오른쪽 길? 나는 지금 왼쪽으로 온건데.	1
그 자식들 웃긴다. 지들이 우리 사이를 알면 얼마나 안다고 그런 소리를 해?	5
형이 그렇게 공부도 잘 하고 선생님들한테 잘 하고 하면 그걸 좀 보고 배워야지. 너는 어째 반대로만 하니?	0
음.. 아, 그럼 다른데 가봐요. 우린 그렇게 못해. 코만 고친다고 두꺼비가 왕자 되겠어?	3
아니 그건 아니고....	4
"너 꼭 필요한 거 있을 때만 엄마라고 부르잖아.	 그것도 무슨 한약 짜내듯이 찔끔찔끔."	3
나한테, 한 번만 기회를 주면 안 돼?	2
안된다고 어떻게 확신을 하냐? 또 알아? 나도 재용이처럼 부자 될지.	0
아니 조금 남아있긴 한데. 한 이만원 있나?	2
왜 쌤 책상 위에 있던 엄청 큰 사탕 통 있었잖아요.	6
엄마 솔직히 말해봐, 천원 짜리 선물이 정성이 있다고 생각해?	4
그냥.	6
그럼. 근데 너, 이렇게 울먹거려 놓구선 막상 소정이 가고 나면 얼마 안 있어서 금방 소정이 홀랑 다 까먹을 걸. 다른 새 친구들 생겨서 걔들이랑 노느라고 정신 없을거야.	3
그럼 정말이지!	7
거짓말 치지마. 너 어제 뭐 입었는데?	0
"네. 아빠가 누가 이기나 보자고 했어요.	  아! 말하지 말랬는데."	4
네? 갑자기 무슨 소리세요.	5
네 안녕히 가세요.	4
하아… 그래요…	6
아무리 그래도 그렇지… 그런 마음가짐으로 무슨 간병을 한다고 그래? 어차피 죽을 사람이라 생각하면서, 대충대충 했을 거 아냐!	3
어. 꼭 만화 같아.	1
에이 선배님 왜그러세요 진짜. 저도 힘들어요. 팀장한테 쪼이지 검사들이 쪼지.	6
뭐 먹을래?	7
10년 동안 안 닦고 쓰시는 거면 그 안에 진짜 뭐가 있을지 몰라요.	0
야, 비웃지 말고 너도 같이 헬스장 다닐래? 넌 나 같은 친구가 옆에 있는 걸 감사해야 돼.	3
난 진짜 한 대리가 그런 사람일 줄은 몰랐다니까. 심지어 같이 점심 먹었던 날에는 나보고 좋은 결과 있길 바란다고 말했다구.	6
"어 그게요… 제가 레슨 땜에 바빠서. 숙제를 깜빡했다가! 오늘 생각났어요!	 근데 오늘 갑자기 동아리에서…"	2
알았어 알았어. 아빠한테 그럼 여쭤보자.	6
어. 걔네 집안에서 난리인가 봐.	2
응. 지구에서 제일 높은 산은… 하와이에 있는 [마우나케아] 야	1
야. 너 이렇게 말 안하면 평생 걔네같은 애들한테 시달리는거야. 그래도 좋아?	0
뭐야 너무 무서워! 아빠 시골집 가기 싫어졌어.	2
언니가 어떻게 알아. 나도 공부 잘하게 되어서 좋은 대학 가야 한단 말이야.	4
 여기 멍청한 놈이 나말고 또 있네. 한명준 학생, 오늘 임시휴교일이래요.	4
피같은 휴가를 이 할애비하고 보내냐? 여자친구랑 어디 좋은 데라도 가지.	1
 언제 오셨어요. 아빠가 저녁 늦게나 도착한다고 하셨는데.	7
지금 사러갈까?	7
그만해. 왜 그런 소릴 해. 나 말은 안해도 늘 감사히 생각하고 있어.	4
저도 오래 고민해보고 말씀 드리는 거에요. 방법은 차차 찾아보려구요.	4
몸으로 떼우고 말지 뭐.	1
몇 년을 봐 온 사인데, 무슨 말을 하는 그리 해요!	0
모르겠어요. 엄청 똑똑하시고 다정하시대요.	5
너무 비싸다 이거야?	2
잘려야 되는거 아니야? 미성년자한테 미쳤나.	3
 아… 저 완전 망했어요…… 답도 밀려쓴 것 같고… 확실하진 않은데….	4
응. 학교에서도 애들이 난리더라. 그거 자동차가 사람을 치고 도망갔다고.	2
그래… 그건 그래. 나중에 대학교 오면 교수님들이 과제 베낀거 없나 프로그램으로 다 돌려봐.	1
자기 나중에 당뇨 오면 어떻게 해?	6
아니, 요즘 우리 과장님이 자꾸 버튼을 눌러가지고.	6
삼촌 이거 봐 봐.	7
진수야 생각은 있는 것 같던데, 그 아가씨 생각이야 어떨지 저희가 모르죠.	4
저기요 총각!	0
그건 그러네.	4
아. 그렇구나.	5
그렇죠. 아르바이트 할 사람 새로 뽑아서 교육시키고, 일 익숙해지고 하는 데 시간이 워낙 오래 걸리니까요. 좀 가르쳐서 일 잘하게 되면 그만두고, 다시 신입 들어오고...	4
삼촌 76년생. 용 띠! 맞죠?	1
그냥 다... 한마디로 총체적 난국이래. 정민대학교에는 원서 넣을 생각도 하지 말래.	4
아이고 그러셨어요? 근데 어쩌나. 내가 새벽에 과일 떼와서 청소 싹 해놓은건데.         청소를 뭐하러 또 하셨어요?	6
엄마 눈에만 잘 생겨서 어디다 써.	0
 오른쪽 2층 상대 피 없어. 포커싱 포커싱.	0
사장님도 자녀가 있지 않습니까? 제 아이들을 생각해서라도, 이번 기회 진지하게 생각해 주십쇼.	2
응. 농사 짓는게 엄청 힘들었거든.. 엄청 고생만 하고..	4
우리 세훈이 앞날이 달렸으니 처신 똑바로 하세요.	0
지훈아 너 요즘 샤워하고 나면 몸이 간지럽거나 그런 건 없어?	2
응. 내가 그때 진짜 잘 해줄게.	1
잘 한 거야. 그래도, 니가 엄마 닮아서, 실행력이 있다니까? 어떻게 딱 단번에 퇴사할 생각을 다했어?	7
그래? 그럼 선생님이 우빈이 좋아할만한 걸로 고민해볼게!	7
사람들이 욕해. 요새 환갑 잔치 차려 먹으면.	1
스타일 죽인다고 하셨는데… 뭐라고 대답하면 좋을지 모르겠어서,‘껍데기 칭찬 감사합니다.’라고 대답해 버렸어요.	2
"그러니까 갑자기 나이가 확 느껴지는데? 	 그때 태교 음악 듣던 애기가 벌써 이렇게 큰 거야? 나 늙었구나..."	7
 어쩐지 요즘 자꾸 거울을 보더라니. 너 저번에 인터넷으로 옷 잔뜩 주문한 것도 걔 때문이지? 으이그. 한참 공부할 땐데.	0
전이요?  아 맞다..!  어떡해요. 형님, 제가 깜빡했어요.   여기서 부치면 안될까요?	5
진짜? 엄마는 그런 것도 알 수 있어?	5
미안해 정말…	4
아! 빨리 말해.	0
아! 근데 미숙이 할머니가 자기가 총무한다고 했구나!	7
….미안하다. 나도 그러고 싶지 않았어.	4
너야, 눈썰미가 안 좋으니까 그렇지.	0
그러니까 그 투자를 왜 내 돈으로 하냐는 거지.	3
아~ 다니엘이요? 은색머리?	5
나.. 강아지랑 고양이 동영상.	7
좀 있으면 점심 시간이라 잠그니까, 지금 나랑 가요.	6
이런 경우 산모가 스트레스를 지나치게 받으면 태아한테도 영향이 가거든요.         그러니까, 최대한 긍정적인 생각들 하시고, 운동도 열심히 하시고요.	2
한복집 꽃자?	1
그래도 주식이라는 게 혹시라도 잘못될 수도 있는데. 괜찮겠어? 좀 불안한데	1
그 강아지가 마음의 문을 벌써 닫아버려서 옆에 다가가기만 해도 으르렁 거린대. 괜한 짓 하다가 물릴까봐 나도 무섭더라.	4
어허.. 안 된다면 안 되는거야.	0
오빠 진짜 우리 집안의 수치다.	3
곧 오시겠네. 저녁 뭐 먹지?	2
아이고... 참나.. 알았어. 그럼 그 다음주부터?	5
어. 우리 딸, 얼굴 보고 싶고, 목소리 듣고 싶을 거 같아서!	7
네?	5
뭐? 바퀴가 나올 리가 없는데… 너 바퀴벌레 봤어?	2
"미안해. 지금 이렇게 말 하려던 건 아니었는데, 	지금이 적절하게 느껴져서."	3
 아이고….	4
음…	1
엄마는 모르지. 느이 엄마는 잔소리가 너무 많아서       이런 거 말하면 안 돼. 큰일 나.	6
"그건 좀 문제가 있다. 	그 친구한테 나는 너 좋아하는 거 아니라고 얘기 했어?"	3
그건 언니가 잘못 했네.	4
헐 뭐? 어떤 섹드립?	5
1시간치 일한건 다 날아갔겠구나...	7
왜 아니야..? 같은 반이잖아?	0
 어머, 얘. 이마가 아주 불덩이네? 너 창문 열어놓고 잤니?	3
뭐? 저거 구멍 뚫린 청바지?	5
아니. 제가 잠시만이라고 계속 말씀 드리잖아요. 아줌마!	0
자꾸 내 머리를 잡아당겨.	6
응. 할아버지랑 할머니까지 다 걸게.	1
어머? 그 빵집 장사 아주 잘 되는 것 같더니 왜 나간대요?	5
안찍었다고요! 놓으세요!	3
음… 꽃 같은건 어때?	7
뭘 그렇게 실실 쪼개고 있냐?	3
"벌써? 열 살이나 됐어? 	그러면 집에 혼자 있어도 안 무섭겠다."	6
우리 화장실에 샤워호스말이야. 그거 교체해야할 것 같아.	2
그래. 아빠는 그래서 한 학년 아래 친구들이랑 학교 다녔어. 너 그거 몰랐지?	1
그럼. 부모님이 맘대로 하시는 거 같지? 엄청 눈치보고 있는 거야.	1
그냥 뭐... 이팀장... 죽어... 죽어...	1
콘텐츠와 전혀 친하지 않은 사람이 어떻게 콘텐츠 사업을 이끌어 갈 수 있을까요? 운전도 할 줄 모르는 사람이 자동차 제조사 CEO가 되는 것과 마찬가지 아닐까요?	3
오늘 학교에서 애들이 놀렸어.	4
응, 내 친구가 하는데, 그래도 돈이 좀 벌리기는 한다더라고.	1
그런가?	7
어. 그런 거 같아. 내가 지희랑 같이 구해주러 갔는데. 우리 둘 다 고양이 만지는거 무서워서 못 구해줬어.	4
저 죄송한데 진짜 급한 일 있는데요	4
에이 설마.. 그 분이 선배 안 좋아할까봐 이러는거에요?	3
네. 근데 저 스타빈 아니면 커피 못 마셔요.	7
사는 게 왜 힘들어. 나는 좋기만 하구만.	7
저 세상이요...?	2
고양이?	5
야 그거 얼마나 하냐?	7
그랬던 거 같애. 사거리 구석에.	1
아… 그러세요? 선생님 글도 쓰셨구나.	2
니가 그렇게 생각하고 있다는 게 걔네들한테도 전해질걸? 좀 당당하게 생각해.	3
당분간은 집에서 통학하려고.	2
딸!	0
왔다 갔다 하면 어쩔건데요?	0
만약… 하게 된다면 그렇죠.	7
몰디브는 잘 갔다 왔냐?	1
나는 동남아. 다낭 이런데 어때?	1
얼마 주고 샀어?	0
바깥 기온에 덥던, 춥던 우리 몸은 체온을 일정하게 유지하려고 한다. 이 뜻이야.	1
엄마는 내 편도 안들어 줄거면서 왜 자꾸 꼬치꼬치 물어봐? 사람 기분만 나쁘게.	4
할머니 뭐 아는 향수 있어?	2
당연하지. 일단 내가 넣은거 알려줄게. 거기부터 해봐.	7
아 뭐 별로 많이 안 빌렸어. 아빠가 그걸 또 말했어?	0
이상한데…	2
"인생이 조금 돌아가는 게 실패는 아니야. 알고 있지? 	 누구나 넘어져서 잠시 쉬는 시기가 있어.  너는 그저 남들보다 조금 빠르게 겪는거야. 알지?"	4
그렇지.	7
가여워라.	4
신발이 작단 말이야.	0
누나 되게 지금 미친 사람처럼 말 하고 있어.	3
"매우 안타깝게 생각합니다. 	어쩔 수 없지요. 학부모님께는 연락 드리셨나요?"	4
응. 근데 요즘도 필름 카메라 찍는 사람이 있어?	5
형은 근데 왜 별명이 울보였어?	4
저희 ‘악마를 보았다’ 컨텐츠를 경험하시고, 차후 해당 컨텐츠의 내용을 발설하지 않는다는 서약서세요.	2
왜. 할 말 있나?	5
고모는 친구 만나러 갈건데?	1
얘, 엄마 시계는 벼룩시장에 팔기엔 너무 비싸지… 근데 아빠가 알면 서운하겠다. 기껏 생각해서 골라왔는데 딸은 그 시계를 차지도 않고, 심지어 팔겠다고 하고, 잃어버렸고!	3
팔로 몸을 들어 올린다는 게 상식적으로 너무 위험한 짓 아니야?	6
어. 동네에서 할까 했는데, 애들이 하객들 오기 불편하다고  교통 편한 데로 하자고 해서.	7
한우였나? 돼지 갈비 아니었어?	5
그건 그렇다.	7
 바쁘실텐데 시간내 주셔서 감사합니다.	7
무슨 소리야? 끼어들긴 누가 끼어들어?	0
좀… 집에서 꺼져라. 어?	3
…미안해. 나는 그냥.. 장난칠려고 그런건데.  미안해. 앞으로 안 그럴게.	2
아니, 우리 형님이 병원에 입원하셨다고 하셔서.	4
무슨 로또를 사. 괜히 돈 낭비하지 말고, 그럴 돈 있으면 나 떡볶이나 사 줘.	1
그럼. 운동은 매일매일 해줘야 하는 거야.	0
어머 정말이에요? 수학을 안 다니는데 그렇게 잘 한단 말이에요?	5
"미안하게 됐다! 내가 헤어져서 동생 결혼하는데 눈치나 주고..!	아주 미안하게 됐다고!	나는 헤어지는 것도 허락 맡고 헤어져야 되냐?"	6
얘가 갑자기 왜 이래?  왜 갑자기 안하던 짓을 하고 그래?	7
밤에는 엄청 무섭겠다. 골목이 되게 좁던데?	2
2월 말에서 3월 초 될 것 같아요.	1
할아버지는 다 알 수 있어. 예끼 이놈, 그만 좀 물어봐.	6
그냥 다 싫어…	4
내가 본다 내가! 요즘 젊은 애들은 꼭 그 조막만한 핸드폰으로 뭘 본다고	3
면접 때문에 사신 거라구요?	5
"바보냐. 내가 성빈 선배 동생이었으면	 얼굴에 써붙이고 다닌다."	3
그러니까요. 장례식장은 어디서 한대요? 저희도 가봐야 하는 거 아니에요?	4
주식도 해?	5
알았어. 그럼 얼른 가서 먹고 오자.	7
음… 이제와서 엔진을 어떻게 할 수도 없고…	2
너 왜 오늘 저녁 안 먹었어? 어제는 내가 안 먹고 오늘은 니가 안 먹으니까 니 아빠가 걱정하더라.	4
나 오늘 좋은 음식 먹어서, 나 스스로를 좀 대접하고 싶어.	4
뭐 찾으세요?	5
그래, 근데 그러다가 엄마 친구 혜진이 알지?	1
아니야, 난 됐어. 너 많이 먹고 다이어트 꼭 성공해.	3
아, 제가 말씀 안드렸구나. 제가 이번에 컨텐츠 기획 회사에 들어가게 되어서, 거기서 소스를 관리하거든요.	4
어떡하죠?	2
얘가 계속 옛날 타령을 하네. 갑자기 왜 궁금해진 거야?	0
"20년을 살림만 한 아줌마를, 누가 써 주겠어. 	 기술이라도 좀 배워놓을 걸."	6
다 못먹고 남기든 싹싹 비워 먹든 제 마음이죠.	3
 뭐어? 얘는 누굴 놀리니.	6
나도 사실 막막해. 경영 쪽을 배워도 내가 직접 경영할 수 있는 것도 아닐 거고.	2
강남역 근처에.	3
그래 그래라.	2
으엑! 아 이게 뭐가 부드러워!	5
근데 그냥…. 더 잘 하고 싶어서.	2
산소 가는 꿈이 왜 악몽이야? 집에서 못 노는 게 그렇게 억울해?	0
목사님은 모르시잖아요. 제 죄가 얼마나 무거운지….	2
세상에.. 어미고양이는 없었어?	2
아니 검색하면 나와. 인터넷에.	7
저, 저, 저 새파랗게 어린 놈이 말하는 싸가지봐?	0
나라에서 부르잖냐. 안 가면 영창 가야 돼.	3
 무슨 까페가 이렇게 많니.	5
아빠, 있잖아, 아빠는 왜 엄마랑 결혼했어?	5
요즘은 그것도 업체가 많아져서… 그리고 그 업체들 뒤에는 깡패들도 있고 그렇대.	2
으이씨. 약간 으슬으슬해.	2
엔진 오일 제때 갈고?	1
"아니. 그래서 고민 중이야.	 준호오빠가 좋아졌으니까, 남친이랑 헤어져야 되지 않을까?"	7
어딨는지도 몰라…	1
그래도 이건 아니지.	6
"재민아, 덥지. 	 차에 에어컨 정확히 25.5도로 맞춰놨어. 얼른 들어가."	7
그래. 근데 이제와서 너를 너무 자유롭게 키운건 아닌가 덜컥 걱정이 되기도 해.	2
네. 수민이가 너무 힘들어해요. 애들이 수민이를 은근히 엄청 따돌리거든요. 같이 놀아주지도 않고.	4
저... 경쟁 회사인 체일기획에서... 스카웃 제의를 받았어요.	7
조카가 이렇게 응원도 해주고.. 힘이 나네!	7
엄마 아빠도 작아진거죠! 엄마 아빠도, 콩이를 피해서 숨었대요.	6
나라에서 이렇게 하라고 정해놨어요!	0
그런데 다 드셨네요?	3
그래도 카페가 많이 생기니까, 맛좋은 커피 마시는 건 좋잖아.	1
태민이는 솔직히.. 제 친구 아니란 말이에요.	0
"어르신. 그러니까 이게 진시황이 찾아다니고 	 클레오파트라가 애달프게 찾아 헤매던, 그 신비의 명약이란 이 말씀입니다."	5
음… 그냥 아빠가 그랬으니까요….	1
 자주 있는 일은 아니죠.	7
저 아이스 아메리카노 큰 사이즈로 하나 주세요.	1
아니야. 엄청 예쁘게 그릴거야.	3
 아직이요.	5
너 왜 이래 진짜 무섭게…!	2
근데, 그러면 현우가 계속 레벨이 안 맞는 반에 있는건데, 괜찮겠어?	6
아니, 우리 세훈이가 무슨 나쁜 의도가 있어서 그렇게 한 게 아니라… 어쩌다가 장난으로...	4
치…. 지금 먹고 싶은데.	6
"나도 이런 거 좋아. 우리 처음 만나기 시작했을 때는 	서로 할 일을 못했었잖아. 	요즘에는 그래도 각자 일에 조금씩 집중할 수 있는 것 같아서 	좋은 것 같아."	7
아 됐어 됐어. 나 치킨 시켜 먹을거야.	3
그럼 내일은 일찍 들어오는 거지?	7
얼굴에 다 나오는데, 어떻게 모르겠어요.        그래서, 여자친구가 왜?	7
아니, 사내애가 장난치다가 그런 걸로.. 뭘 그럼.. 야단이라도 치라는 거예요?	3
우리 부모님 이혼하셨잖아. 따로 사셔. 엄마한텐 아직 안 물어봤어.	1
진짜? 결국 떠나는구나.	5
엄마 나 유학가고 싶어.	6
그런게 있어? 근데 난 그냥 매운 라면 먹고 싶은데.	5
아.. 왜 갑자기 화를 내고 그래?	2
까먹기는. 맨날 그러면서. 엄마가 맨날 콩이 밥 주고 똥 치우고. 이럴 줄 알았으면 콩이 안 데리고 왔을거야.	0
우리 앞으로 30년은 더 살텐데.. 앞으론 점점 더 심해지겠지?	2
새벽반 진짜 힘들지?	6
옷에 미세먼지가 묻는다는 거 말이에요.	1
당신이 그거 다 옮기고 하다가 몸살 나고 골병만 들지. 돈을 주고 누가 해주는 게, 나중에 더 돈 들것도 줄어드는 길이야.	2
응. 치킨의 생명은 기름이지.	7
내가 지금 소리를 안 지르게 생겼어!	0
그럼 한 시간으로 할까? 생각해보니까 두 시간도 너무 긴 것 같다.	1
20살 21살 이런애들이 보기에는 나는 늙은 거 아닐까?	3
어떤 일 때문에 오셨어요?	7
아이고…. 오늘 못 보면 몇 달 뒤에나 볼텐디. 	6
고마우면 앞으로 누나한테 잘 해. 아침에 일어나면 누나방을 향해서 세 번 절해.	1
아.. 아니에요, 아빠.. 아, 이건 진짜란 말이에요.. 그 날 아파서 시험 못 쳤어요.. 죄송해요 ..	2
응. 알았어.	1
네, 네. 이거 죄송하게 됐습니다.	4
8반 아이들이… 오늘은 5반 가서도… 그랬다고 하더라구요…	2
그치만…. 저희 콩이가 사라져서.	4
왜? 이런 얘기 꿀꿀해?	3
달라!	0
" 저게 누굴 닮아서, 저러고 다니는 거야.	 저런 게 대체 어디서 나왔어. "	0
맞아. 맞아!	1
그래요? 아 진짜.. 그거 근데 조선시대에는 걸리면 사형 아니에요? 사약?	2
 그래. 잘 했네.	5
그래서 저는 너무 힘들다구요!	0
아니 없어.	4
"뭐어? 아니야~!	 니가 무슨 아빠 판박이야.	 아빠 유전자엔 니가 없어."	5
야! 비교하지마!	0
나? 글쎄… 안 해본지 한참 되어서. 한 오십 개 하려나?	1
전교 회장 선거? 이야… 도진이 너 거기 나가면 전교 회장 될 자신 있어?	7
못 들었어? 방금 드륵 드륵 긁는 소리 같은 거.	2
그래. 돈 아깝다고 더울 때도 참지 말고, 꼭 에어컨 틀어.	7
 네, 저야 뭐, 별일 없이 잘 지냈죠. 선생님 얼굴이 더 좋아지셨네요.	7
한우?	5
근데 우리 주 교재가 리딩 교재잖아. 이미 애들 다 샀는데 그건 어떻게 할거야. 환불해줄거야?	6
아냐. 진짜 맛있었구나?	7
거짓말이지! 술 냄새가 나는데!	0
그렇구나…	4
와.. 너 엄마 아빠한테도 그렇게 말해?	3
아 진짜 까다로운 자식. 어디서 이런 자식이 나왔나?	0
"	그럼 이거 면 버리고 다시 할까?"	7
참내, 그래서 어때, 선물 뭐 생각했어 그럼	3
더 드세요. 쭉.	7
 그래서?	2
이번 작품은, 모든 것을 잃고, 단 하나의 목표만을 위해        달려가는 남자의 이야기를 담았습니다.	6
그런게 아니라…	0
그래 그럼 내가 전화해볼께. 이번에도 현금으로 한다고 좀 깎아 달라고 해야겠다.	1
에이 코 묻은 돈 뜯고 싶냐?	3
많이 힘들구나. 엄마가 그것도 모르고.	4
"알지. 괜찮아. 		에이, 아까 니 말 듣지 말고, 그냥 면 새로 할걸…	내가 면 새로 했어도 먹었을거지?"	7
제가 질문들을 준비해 왔고요. 그냥 편하게 대답해주시면 됩니다. 아! 참! 그리고, 오늘 나누는 대화들을 제가 핸드폰으로 녹음해도 될까요?	1
바른 말을 하는게 바른게 아니라구요?	3
거짓말.	3
나? 나는 없지. 날 봐. 이미지가 쎄잖아.	6
그래. 말해줘서 고마워.	7
응.. 인생이 뭔지도 모르면서.. 공부는 왜 할까?	1
"맞아. 이 정도면, 누나 거의 내 아바타 수준인 거 같애.	 내가 누나 아바타인건가."	2
이 자식이 지금 상황 파악 못하고. 그게 중요해 지금? 엄마는 성적보다 거짓말한 게 더 화나고 기분나빠.	0
누나 속물이구나?	5
어. 원래 산수만 했었는데, 엄마가 중국어랑 영어까지 시켜서 진짜 미치겠어!	0
맞다. 왜!	0
야 내가 지금 이렇게 너의 초기작을 봐주고 있잖냐. 이 정도면 지분 있는 거 아니야?	0
"아휴.. 또 아무것도 안 했겠구만. 	알았어."	6
너 그거 지금은 괜찮아도 나중에 아플 수 있어. 얼른 병원가봐.	2
"아이고. 너는 속 편해서 좋겠다.	 엄마 속은 이렇게 타들어가는데!"	0
자세히...봐도, 아무 것도 없는데?	5
어머니한텐 비밀이다…?	2
엄마, 나는 엄마가 너무 좋아..	7
됐고. 여깄다가 애들 출석 끝나면 전화해.	3
맞잖아. 언니 지금 나보고 멍청하다고 한 거 아니야?	0
무서운데...	2
나 삼천 원 있어.	1
부모님이 뭐 하시는데? 교수님? 학자?	1
네....	2
미안해요, 선배. …..  …..아까는 제가 좀 흥분했어요.	4
아 예, 어머님만 믿겠습니다.	2
그건 아니지. 그걸 왜 형욱이가 가져가.	0
요즘 원가로 가격 생각하면 바보야. 제품 안에 들어가는 다양한 요소를 고려해봐야지.	1
어머. 감사해요.	1
나는 이제 나이 든 꼰대지.	4
있어.	7
그럼 좋아하는 게 아니라, 잘 하는 걸 해야 되는 거 아니야?	2
나는 저번에 아빠가 그 진수 아저씨 얘기해주고 나니까… 안 나갔으면 좋겠다 싶어.	2
"아니, 그깟 고추가 문제에요? 	 어머니 그러다 저번처럼 쓰러지시면 어떡하실려고 그래."	6
둘째는? 생각 없어?	1
네…뭐….	6
응. 제목이 뭐가 중요해. 지금 극장에서 1위하는 영화 보고 싶다니까.	0
아, 있다가.	6
아니 티비에서. 헬스 트레이너가 그랬다고. 진짜야.	0
고모는 근데 왜 요리 안 해요?	6
 할머니 집에 혼자세요?	2
튜브? 웬 튜브?	5
그러려면 운동을 열심히 해야겠는걸?	5
응. 근데 그래도 추억여행 삼아. 가볼까 했지.	4
제가 25층에서 근무를 하는데. 여차하면 들어서 내던지지 뭘. 이렇게 생각해 버리고 만다니깐요.	0
죽은 거 아니야.. 아직 살아 있으니까! 119 부르라고.. 119를 부르면 어떻게든.. 그 사람들이 해결을 해 줄거다...	2
"저만한 사이즈로 나온 게, 거의 없어서 그래.	 맞추면 너무 비싸고."	6
거의 하루에 두 권은 보니까…?	1
삼촌 뭐해?	7
왜?	5
뭐?	5
아니야. 처음에 한국에서 만났대. 두 달은 한국에서 같이 지냈나봐.	7
저기요, 방금 세탁기 돌리신 거 그 쪽 맞죠?	6
나는 장난처럼 안 느껴져! 모욕적으로 느껴진다고!	0
"아... 좋네요...	 근데 앞에 상가하고 엄청 가깝게 붙어있네요?"	6
그러게. 할아버지는 마우나케아라는 산 이름조차 처음 들어보는 것 같아.	1
아.	4
그래? 그러면 바베큐 도구도 사야겠구나?	5
삼촌 나 코 수술할까?	2
누군데? 그 때 말했던 걔, 동준인가 뭔가 하는 그 자식이냐?	3
적어! 안 적으면 안 보내줄거야!	0
엄마는 드라마 말고는 바깥 세상을 만날 일이 너무 없어…	4
그렇구나. 그럼 다행이긴 한데 내가 미안해서. 혹시라도 내가 도울일이 있으면 뭐라도 괜찮으니까, 편하게 이야기 해요.	4
불러 경찰.	0
그럼 내 성의를 봐서 한 모금만 마셔줘. 그건 괜찮지?	1
아이고 고맙다. 고마워.	7
야야. 제수씨한테 전화해봐.	5
정책 같은 소리 하네. 여기가 국회야? 쬐깐한 동네 미용실 나부랭이가 무슨 정책 타령이야.	3
솔직히 사장님 완전 악덕 업주예요. 최저시급도 안 되게 시급 주시고…..주휴수당이 뭐야, 야간 수당은 바라지도 않아요.         근데 더 끔찍한 건, 사장님 그 썩어빠진 마인드예요.	0
아무것도 아니라서 다행입니다!	0
절에서 절밥 주는 데 뭐.	7
동네 제일이지. 너 안 먹어 봤어?	1
매일 쓰지 말아야 하는데. 편한건 사실이니까.	4
알았어. 너야말로 저번에 무릎이 아프다며? 병원은 갔어?	6
아구. 미안해 엄마가. 엄마가 요새 이렇게 깜빡한다.	2
하.. 나 진짜 인내심에 한계를 느끼는데… 야… 우리는 경찰로서… 이렇게 신고가 들어오면 조사를 안 할 수 없어… 근데 왜 말을 못 하겠다는거야? 말을 못 하겠으면 신고를 하지 말았어야지..	0
있으니까 먹었지.	5
... 내가 어떻게 하면 되는데.	3
뭐야. 왜 밑밥을 깔아. 누군데 그래.	5
예지 엄마가 허락을 해주겠냐? 너 같은 솔로나 이런 차 타는 거야.         나는 바꿔도 아마 국산 SUV가 아닐까 싶다.	0
응. 완전. 넌 내 보물이야.	7
"지루할 때도 있지. 근데 그렇게 만나는거지. 	어떻게 맨날 짜릿하고 자극적이고 그러냐? 	평양냉명같이 슴슴한 맛에 만나는거지."	7
이 사람이 운명처럼 느껴졌어. 마법처럼.	5
경찰이면 그렇게 아무거나 막 물어보셔도 된다는거에요?!	0
아직 고민중이야… 저번에 사다놓은 고기 재워놓은 거 구울라고.	1
어머.. 그런 식으로 무릎이 나가버릴 수도 있구나. 너무 놀랐겠다.	2
...재민아, 너 카스트라토라고 알아?	2
그래요...?	3
조금만 버텨주세요. 거의 다 왔잖아요.	6
에휴. 할머니가 너 걱정하는게 일이지 뭐.	3
아니 그렇잖아. 공공장소에서는 조용히 해야지.	0
그만하라구!	6
넌 좋겠다? 공부 잘해서.	3
그렇게 무서운게 12세밖에 안된다고?	6
 정말? 안되는데.	4
제가 건물주인데요.	3
니 엄마도 아빠가 얼마나 민감하게 반응할지 몰랐던거지 뭐.	1
제가 처음부터 분명하게 말씀 드렸잖아요. 희찬이 땅콩 알레르기 있다, 그러니까 제대로 신경 좀 써 달라.	0
야, 내가 무슨 죄가 있냐! 나 혼자서 낚시 가는 것도 안 된다는 거야?	3
어쭈 왜 말을 못해? 진짜 나쁜 생각해?	5
엄마랑 아빠랑 나랑 셋이 모으면 미국 한 번 왕복은 나오겠던데.	1
알았어! 내가 얘들 생명줄을 잡고 있는데… 절대 잊어버리지 말아야겠다!	1
나도 뭐 오래 된 거 아닌데.	6
네. 뭐 좀 확인하고, 준비물만 챙길게요.	2
"아까도 5분 더 한다고 해서 할머니가 10분 줬지~~? 이제 그만!	 엄마랑 컴퓨터 게임 조금만 한다고 약속했잖아?"	0
응. 알았어. 너 암 보험이나 그런건 있어?	2
아, 결혼 기념일. 벌써 그렇게 됐나?	5
빨래통? 아 엄마 아직 빨래 안 했던데. 아씨.. 지금 나가야 되는데.	5
오래 두고 먹는 것 들이라 많이 해 갔으니까.	1
어떻긴. 나쁘지. 아씨. 언제 서른이 됐냐. 진짜.	4
그 놈이 자기 좋아하는 김자홍이를 붙인다고 나를 떨어뜨렸어. 편파판정이지.	0
그래, 가서 싸인 많이 받구 와라.	3
저 새끼 무슨 전환데 밖에서 받냐.	0
그랬어? 뿌듯하네.	7
진수 엄마랑, 진수 둘 다.	0
엄마 나 방학 때 축구캠프 보내주기로 했잖아!	0
"요즘에는 다들 많이 해. 	다 개성인데 뭘."	6
 서류 열심히 쓰고 있지...	3
 완전 지쳤어.	6
할머니가 엄마랑 한 번 이야기 해볼게.	1
그런데요? 그게 가방이랑 무슨 상관이 있어요?	2
일주일이 뭐냐. 못해도 한 달 전에 알려줘야 되는 거 아니냐? 계약서 안 썼어?	0
내가 뭐 부모님 욕을 했어? 인신공격을 했어? 뭘 했다고 이렇게 주눅들어서, 꼬리내리고, 눈치보고 있어?	0
잘 한 거야. 하다못해, 우리가 찻집을 해서 망한다고 하더라도, 다시 가방 짊어지고 일어설 힘만 있으면, 언제든 다시 시작할 수 있는 거라고. 그게 인생이야.	7
그래, 나한테 상담할 게 있다고?	1
"현우야아~ 고모가 너한테 뭐 부탁하는 거 봤니? 	한 번만 지우한테 양보하자."	2
나가!	0
 어? 이모 일하는거야.	6
아유… 이걸 어쩜 좋니 정말…	2
그거는 좀 비싼데? 이만 오천 원.	2
마라톤을? 갑자기 아버지가? 에이… 난 좀… 너무 힘들거 같아. 몇 년 전에 뉴스에서도 60대 남성이 마라톤을 뛰다가 갑자기 심정지가 와서 쓰러졌다고… 에이. 난 너무 위험한 거 같아서 솔직히 반대에요.	2
못해? 반말하냐?	3
아 거참 귀찮게 하네.  니가 이 게임을 못하는 이유는, 우선 니가 겁나 어려서고,  어린 애들이 보아선 안되는 선정적 장면들이 있기 때문이지.	0
네. 점심시간에 회사 근처에 있는 곳 돌아다니고 그래요.	7
아니.	3
엄마 아빠가 나 키워주신 거는 고마운데, 같이 하루 이상 있는거는 이제 너무 힘들어. 특히 여행지에서는 같이 안 있고 싶어.	6
아, 네, 제가 어제 거래처에 확인했어요.	3
그래서 얼마 썼냐고?	2
그냥 뿌려봤어.	2
아 또 그 소리 해. 레퍼토리 좀 바꿔봐.	0
오빠 나 크리스마스 선물 뭘로 줄거야?	7
내가 안 만졌다고 몇 번을 말해! 아 짜증나.	0
왜?	6
네. 맞아요. 푸들이에요.	5
아빠 맨날 저녁식사 중에 반주하잖아.	0
그런게 어딨어 나 엄마 보러 갈거야!	0
그래. 잘 생각했어. 나중에 아플 때 서러운거 보다는 한 달에 몇 만원 내는게 나아.	1
그래도 대학을 가야 사람 구실을 하는거야.	0
평균 92 이상?	2
그래요? 15만원이 싸게 올린거에요?	0
교대 졸업하고, 지금 초등학교 선생님이래. 집안도 괜찮고.         그리고 내가 들어보니까 엄청 미인이라던데.	7
진짜야 자식아. 아 나 좀 써봐. 야, 내가 진짜 죽겠다.	4
뭐야. 빨리 일어나. 	0
그러니까 앞으로 문단속 잘해, 알았지.	2
조금만 참아봐. 아빠 금방 온댔어.	4
에휴. 여기 뭐하러 왔어. 얼른 집으로 가!	4
거기, 어딘지 안내 좀 해봐라.	6
연진이? 연진이가 누구야?	5
네. 합의금 드리면 되잖아요. 얼마를 부르든 상관없이 드릴게요.	0
한 번 봐봐.	1
정말 혼자 다 드실 수 있어요?	3
응. 지켜봐!	1
고모도 한번 당해봐야 돼!	3
진짜 끔찍해.	3
나도 돈 가져왔어. 	1
너무 신기하다.	5
나라는 못 사니까, 도시를 살거에요.	7
네 뭐 필요하신 것 있으세요?	2
네. 수업 첫 날 출석했습니다.	1
뭐라는 거야. 남의 사생활에 신경쓰지 마세요. 계산이나 해주세요.	6
아니 그렇잖아~ 애들이 선생님이 오죽 안 무서우면 그런 장난을 쳐? 우리 반 애들은 내 앞에서 그런 장난 절대 못쳐.	2
얘, 도연아. 연락 좀 하고 살아 이 기지배야.	3
선생님이 직접 타실거예요? 아님 선물?	5
아니, 뭐가 마음에 들어.	6
왜 갑자기 고민 있냐고 해?	5
아...	6
폐가엔 어린이가 놀기엔, 꽤 위험한 풍경들이 펼쳐져 있었을 거 같은데요.	2
 진짜 신기하다.       진짜 몇 달 전만 해도 너랑 이렇게 될 줄 몰랐는데….	7
어떻게 된거지 진짜… 아 하필 내가 한눈 판 사이에…	4
내가 뭐 바본 줄 알아.	0
진작 미리 쓰지. 왜 그랬어?	3
아유 언니 그런 소리 하지를 마. 이렇게 정정한데, 한참 더 살아야지.	6
너가 다 해간다고?	5
그럼 오늘 알게 된 거야?	1
개혁이 필요해…	6
하라는 건 뭐든 할게요!	2
예? 간호사한테 들으셨어요? 여태 아저씨 보셨잖아요. 이제 상태가 좋아지시기는 아무래도 힘들어요.	3
뭐?	6
아… 그래도, 참… 어렵게 닿은… 어렵게 기회 닿은건데… 한번 도와주시면 안되겠습니까?	4
그렇겠지? 아. 나도 주식을 한 번 해봐?	7
네. 맞습니다! 우리가 마감일 못 지킨건 사실이에요!	4
가슴이 답답하기까지 해? 너 너무 걱정이 많은거 아니야?. 그러다가 일찍 병나.	5
누구 이사?	5
넌 중학교 어디로 가고 싶어?	4
걱정? 넌 희순이랑 싸운 얘기도 안 해줬으면서, 언니 얘기는 바로 엄마한테 얘기하려고 해?	0
네. 그럴게요. 너무 혼란스럽네요…	2
운동삼아 오는 거지, 운동삼아 슬슬.	0
나 근데 진짜 껌 자주 삼키는데?	5
제가 사장이니까 저와 말씀하시면 됩니다... 일단 진정하세요.	2
 선생님!	5
삼촌, 핸드폰 놓고갔어.	4
근데 진짜 중학교 가서 공부하려고. 그게 내 마음이 편해.	4
뭐?	5
다 먹을 수 있어.	6
요즘 애들이 돈 모아서 집 사기가 어디 쉬워? 그러니까 부모한테 기대는 거지.	4
아니, 내가 오늘 너무 힘들어서. 자리 좀 양보해 줘.	0
"그러게 우리 회사로 들어오라니까. 	아 다른 데 가서 고생을 하냐?"	6
마포 고모. 아 아니다 이제 부산 내려가셨으니까 부산 고모.	1
쥐 쓰리 같은 경우는… 진짜 쥐 파이브랑 후면부 디자인 거의 동일하고.. 실내도 크게 나와서, 선호도가 높아요.	3
엄마가? 어디 놨을까?	5
 그래요.	7
 어머, 나리 학교가니.	5
어리다고 무조건 반말해도 괜찮은거에요?!	0
응, 말해 봐. 뭔데?	5
오늘 왜 이렇게 비가 많이 와.. 꼭 귀신이라도 나올 거 같네..	2
이를 거지?	3
아니, 근데 수한씨.	6
철수가 그러더라, 천 만원이면 사람도 죽여준다고.	3
별 말씀을요. 그럼, 다음 교수회의 때 뵙겠습니다.	7
사생활이고 뭐고… 그냥. 하.. 뭐… 나이들고 보니 더 이상 싸우기도 싫고 해서, 이혼 하기로 한거야.	4
어.	6
나 이제 운동 좀 시작하려고… 아무래도 안 되겠어.	1
진짜야. 너무 잘 하고 싶으면... 그게 싫어지기도 해.	1
요즘 몸이 예전 같지 않아.	4
어떻게 별일이 아니에요? 하루 아침에 연락이 끊겼는데.. 너무 안일하게 생각하시는 거 아니에요?	0
어머. 왜.	5
잘 생각 해봐. 내가 시급 2천원 올려 줄게. 이 정도면 파격 인상이다.	1
아니 얘가…	4
네, 잘 알죠! 깡패 출신 경찰 아닙니까?!	0
진짜… 이제부터 나한테 동생이라고 하지마.	3
기분 나쁘게 왜 그런 농담을 해?	0
왜. 때리게? 때려봐.  교무실이 바로 앞인데!	3
근데 아까 이민석이라고 했는데.	3
아니, 지금 유산 얘기가 아니잖아요. 아버지 노후는 챙기셔야죠.	0
에휴. 아빠가 미안해. 그냥 얘기 해봐.	1
너 이번에 같이 간다는 지영이? 걔 여자애지?	3
하…	2
애가 감자범벅을 안 먹어 봤다 길래. 내가 해줬지.	1
"	재밌어?"	7
다 늙은 노인네한테 오백원 깎아먹고 싶어? 심보가 못 돼 쳐 먹었구만.	6
근데… 너 샤워는 잘 하지?	3
그래도 놀다보면 저녁 먹을 시간 될 거 아니야.  집에 반찬도 다 떨어져서, 안 그래도 마트 갈까 하는 즈음이었어.	0
잘못했어요…	4
속이 다 후련하다.	0
"	오셨어요."	6
그래? 그럼 아빠는 무슨 이튜브를 하지…?	2
그러든지 말든지. 나는 안 써 귀찮아	3
대상포진? 어디에?	4
엄마는 왕따 이야기 듣고 뭐라 안 그래?	3
아니 그래서 그 날 저녁에 걔가 우리집 데려다준다 해서       같이 강을 따라서 쭉 걸었거든.        근데 그날따라, 걔가 엄청 잘생겨 보이더라?        그래서 그냥 손을 잡아버렸어.	7
뭐가?	3
좋잖아. 잘생기고, 싹싹하고, 다정한... 왜? 넌 그 사람들 맘에 안 들었니? 난 그 파마한 청년 참 좋던데.	2
응.. 그래서 애들 오분 십분 지나니까 막 울고 그랬어	4
샀어.	7
아, 네. 일전에 10분 분량의 로맨틱 코미디를 써봤습니다.	1
아이, 참, 조금만 더 기다려, 다 됐으니까. 내가 아주 끝내주는 매운탕 끓여 준다고!	7
그래?  어쩐다니. 남자 잘못 걸렸구나.	4
메일이랑 문자로 말씀드렸던 성적 이의 신청 때문에 왔는데요.	0
어. 나도 처음에 보고 충격 먹어가지고.   나중에 자식 낳으면 어떻게 대화해야하나 벌써부터 걱정된다 진짜. 걔들이 나 욕할 때 못 알아 들으면 어떡해? 번역기 필요할 듯.	1
고생했다. 야~ 우리 진성이가 진짜 유부남 된 거냐.	4
어우 그럼요. 요즘은 남자 분들도 많이 배우러 오세요.	7
뭐가.	5
어휴 우리 세빈이가 밖에서 저러고 다닐까봐 걱정이다.	6
너 원래 맨날 1일 1똥 했잖아. 갑자기 왜 그래? 변비야?	5
어, 예전에 나 보험 도와주신 분이 되게 잘 했는데.. 벌써 10년 전이니까 그 분이 아직도 보험 일 하...할지를 모르겠네.	2
"아.. 아니요. 그게 아니라 원래 짐이 별로 없어요. 	이사를 많이 다니다 보니까 짐이 많으면 불편하더라구요."	7
왜 그러는데? 아빠 너무 답답하다.	2
아, 아니야. 아니야. 내가 갈래! 네 덕분에 오랜만에 연극 구경 좀 하자.	1
춤? 오오 할머니 춤 잘 춰?	5
스토커랑 사생이랑 달라요?	7
사람들은 꼭 그렇게 군대에서 귀신을 봤다고 하더라.. 그거 다 너무 힘들어서 헛것을 본 거 아닐까?	3
너 그게 얼굴이랑 사생활 다 공개 되서 얼마나 힘든데 그래.	4
아... 정말 정답이 없네요.	4
"그거네 그거야. 	자식이 조금 더 배려심 있게 해줬어야지. 	약이나 핫팩을 사준다거나."	7
나는 눈이 좋아서, 글자 크기를 바꿀 일이 없었어.	2
"부모님 차를 종종 끌고 다녀서 실운전도 가능합니다. 	 무슨 일이세요 교수님?"	2
아 아빠 제발.	4
와…	5
해봐. 이게 효과는 직방 일 거 같아.	1
미안해.	4
근데 뭐 문제라도 있나요? 왜 물어 보세요?	5
무슨 약속? 아 귀찮게 하네. 꼬맹아.. 쉽게 가자 쉽게. 응?	0
 진짜요? 어떻게 다정하게 해줄건데요?	7
아.. 그랬구나. 어디 지원 할건데?	1
나도 그것 좀 사줘 봐. 집으로 주문해주면 내가 돈 줄게.	1
야. 너 혼자 먹어.	3
아니야 언니가 얼마나 모범생이었다구~ 공부도 잘 하고 성실하고	0
이제 3년차 아니에요?	6
어우, 글쎄요...	2
응, 이게 좀 늦어졌어. 사람들이 좀 밀려가지고.	4
돈 안 번다고 눈치를 눈치를. 애들한테 들어가는 돈이, 왜 이렇게 많냐,        장 보는 데, 왜 이렇게, 비싼 것만 사냐.        살림을 한 번도 안 해봐서, 이게 얼마나 힘든 일인지,        돈이 얼마나 드는지를, 몰라요.	4
너도… 일찍 죽고 싶지 않으면… 골고루 좀 먹어라.	3
그래도 좋겠다, 이제 새 집 들어가겠네.	1
그렇겠구나. 지금 생각하니 다 애틋하구나.	4
뭐가 싫어. 너 이 음료수도 형이 사준 거 잖아.	4
아, 뭐… 죄송합니다. 불편하신지 몰랐네요.	1
오냐. 고맙다. 고마워.	7
나랑 어떻게 절교를 해.	3
선생님이요... 그쵸? 선생님같으면요.. 일단 지상준이 걔네 이름 들으면요.. 걔네 가만히 둘까요?	2
좀 됐어. 올해 초쯤.	4
그렇지. 스토리는. 잠입수사에서 겪는 주인공의 내면의 변화가 되는 거지.	1
그럴까? 어떤 옛날 얘기 해줄까?	5
상윤이? 왜?	5
그래도 일 년동안 봐야되는데 선생님 너무 싫어하지 말고 잘 지내봐.	6
하... 진짜… 큰일 났어요… 진짜… 어떡해요…?	2
 저 온다고요? 감사해요.	7
내가 너 요만한 때, 너 데리고 이 병원 딱 요 자리 와서 기다렸었는데. 그게 벌써 언제냐…	7
할아버지랑 같이 게임 같이 할래?	1
이제 2년정도 됐어요.	2
맞네, 맞아.	7
남의 아들 결혼에 감놔라 배놔라 하지 말아라.	4
음.... 근데... 내가 영어를 잘 못해서...	2
니가 백년 벌 거 나는 십년이면 벌어. 얼굴 하나 보고 만나줬더니 주제파악 못하고… 어디 고무장갑을 디밀어 디밀긴!	0
말을 해야 선생님이 아는데…	6
언제 산 건데?	5
안 되는 게… 없는 나라요…?	5
응, 나 단 걸 평생 못먹게 된 걸까? 어떡하지?	4
나는 진짜 이런 거 너무 싫어. 삽겹살 집에 돼지 그림 있고, 양고기집에 양 그림 있는거!	6
뭐 보고 있는거야 너? 식탁에 먹은 건 그대로 늘어놓고.	0
아 예... 	6
그것도 괜찮네.	4
 야, 성호 죽었잖아.	2
손님. 여기서 자꾸 이러시면 경찰 부를 수밖에 없어요.	2
맛있게 하려고 신경 많이 쓰거든요.	7
오늘 엄마도 중요한 미팅이 있다고 해서.. 이따가 연락해보려고. 지훈이 너무 걱정 말고 얼른 숙제하고 학원 가.	1
난 또.. 그럼 나랑 하는 채팅방으로 들어가	5
그래. 평일이라 사람도 없으니까 맘껏 달려. 누나가 서포트해줄게.	7
선생님, 여자 친구 있어요? 좋겠다.	5
뭐? 무슨 귀신 씨나락 까먹는 소리야.	5
저 선생님 같은 어른 처음 봐요.	1
그러지.	2
"네. 감독님, 그럼 멀쩡한 정신으로 내일 봬요.	 저 먼저 가볼게요! "	6
그니까 이렇게 아무나 마음만 먹으면! 들어올 수 있다는거 아니겠어요? 그래서 이 회사는 보안 시스템을 새로 구축해야돼 내가 알아	0
참네, 다른 거 먹어서 그런거라고요. 그날 명란 스무 팩도 넘게 팔았는데, 다른 손님들은 아무 소리 없습니다.	0
삼촌 결혼 안해요?	3
보니까 이 아파트 방역하는 업체가 대충 하더라고.	1
선생님이? 담임선생님이?	5
근데… 나 혼자 가기 무서워.	2
" 그래서,	 어떻게 하고 싶은데. 	 채널 접자고?"	6
아 몰라. 다 귀찮아서 그렇지.	1
그래. 너 그 머리 스타일부터 좀 바꿔야겠다.        촌스럽게 머리가 그게 뭐냐?	7
"너 미국이 어딘줄 알고 혼자 미국을 가겠대? 	당연히 안되지. 왜. 영어 공부가 하고 싶어?"	6
한 번 사는 인생 랜덤으로 재밌게 살고 싶어서.	6
"아니. 그런 거 아니야.	 나 그냥 돈 벌을래."	6
네. 먹고 갈게요.	1
네! 당해보시니까 어떠세요? 눈 하나 깜짝 안하고, 사람 바보 취급하셨던거 그대로 당해 보시니까 기분이 어떠세요!?	0
창피한 과거?	0
걱정하지 말고 어여 들어가봐.         아이고…	2
그래. 숙제 뭐 있는데? 학교 숙제 아니며는 학원 숙제?	7
아이고, 죄송합니다. 가볍게 시작하려고 했는데. 	7
나도 하늘나라 할머니 만나보고 싶다!	4
…. 제가.. 진짜 못 죽을 거 같아 보이세요?	2
너 오늘 학교에서 누구랑 싸웠어?	6
너가 좀 그리다가 정 힘들면 나한테 헬프 해.	3
신 팀장이 그래요? 나 참 어이가 없어서. 내가 회사를 스스로 그만 뒀다고?  들어 봐요.	6
참나… 이것도 귀찮다 저것도 귀찮다. 너 그렇게 귀찮아서 숨은 어떻게 쉬냐?	3
뭐가 좋은데?	0
근데 선생님이 잘 가르쳐주셔서, 쏙쏙 기억에 다 박혔어요!	2
비밀이야. 점심시간에 도시락 뚜껑을 딱 열고 맞이하는 스릴이 있어야지.	7
정확히 말하면, 좋아했었어. 지금은 마음 정리했어.	4
사실은.. 내가 하던 회사 있잖아. 그게 망했거든.	4
저 구석만 난리네.	6
응.. 집에서도 청소 잘 안 하면 엄마한테 엄청 혼나.	1
잠은 뭐. 게스트 하우스 같은데 가거나 호텔 빌려야지.	4
웃기지마. 무슨 밥값이야. 요즘 먹을 만한 음식 사 먹으려면, 만 원도 적어.	3
아니… 이게 왜 엄마 잘못이야.	3
네, 무슨 문제.. 있으신가요?	2
 알았어. 알았어.	3
예전에 친구가 선생님한테 말했다가 형들한테 진짜 죽기 전까지 맞았어요. 걔는 파일럿이 꿈이었는데 눈 한 쪽 실명 돼서 비행기는 이제 꿈도 못 꿔요.	2
누나 이 책 읽어봤어?	1
학교에서 형들이…	4
아니야?	3
왜 찍는데요?	6
싱싱한 굴을 넣어야지. 큰 거 말고 작은 걸로.	6
 정말 감사합니다... 제가 참 칠칠맞게... 오전 내내 이것만 찾으러 돌아다녔는데... 어디서 찾으셨어요?	7
그래. 근데 그렇게 무거운 건 아니라서, 너 혼자서도 들 수 있을거야.	1
있지.	4
그 사람들은 왜 결혼을 안 한대?	5
나도 내가 뭐 잘못한 거냐고, 잘못한 게 있으면 말을 해달라고 얘기 했거든?	4
어. 그때는 주로 밖에서 먹을 일들이 많을 때라서.	1
아 미안해…	4
그래도 맛있잖아.	3
내가 다시는 그집 초밥을 먹나봐라…	4
응... 엄마가 워낙 깔끔해서.	1
네?  그게 문제가 되나요?	5
이거 하늘왕국.	7
그건 그냥 공부 잖아? 그건 해야지. 그걸 자동화하려고 하면 어떡해?	3
니가 뭐가 힘들어?	3
아니 애 이마에 흉이 남을 수도 있으니까.	4
초콜릿…	2
저기 차, 몇 동, 몇 호차인지 알아보시고 인터폰 해주세요.	0
어! 저기 뚱땡이 지나간다. 니 남친아냐?	5
여기 온 김에 많이 먹고 가. 내일 아침에도 고기 먹자.	7
왜 그래 갑자기...? 내가 반찬 좀 신경 써 달라고 했다고 그러는거야?	6
" 그것 말고도 돈도 엄청 들거고...	 어디로 가고 싶은데?"	4
우리 아빠가?	5
그래도 3만원만 빼주세요.  학생이라서 그래요.	4
어떤 과자 좋아하는데요?	7
아 그건 깜박 잠든거였구.	6
응~ 니가 은근히 점점 학교 열심히 다니는거 같아서 기분이 좋네~	7
맞아. 형수랑 똑같아서 우리가 안도했는데.	7
언제 가지. 당일은 사람 너무 많을텐데.	2
아… 진짜 갑자기 급 똥이 마려워서…	2
"그러니까 하기 싫어요. 	남은 게 너무 많아서 하기 싫어요."	6
사랑한다고요?	5
그거야, 사람들이 많으니까.	6
그게요...	2
"막내라고 엄마 아빠가 너무 오냐오냐 키웠어. 	애를 배려놨어."	6
용 꿈도 아니고, 무슨 오만 원씩이나 받아?	3
아…그게…제가요….	2
야, 너 한국인 맞아? 그래도 응원해야지.	0
네, 감사합니다. 선생님… 열심히 할게요 저도!	7
전반적으로 신뢰도가 너무 낮은 사회가 됐어…	4
음… 지금 너 여자한테 니 먹을 생선가시 발라달라고 하려는 거 아니지?	3
 근데 끝이 안 좋았어.	7
"그이가 맘이 약해서, 모질지를 못해.	 수익이 많이 나면 뭐해. 인건비에서 줄줄줄..."	3
더 이상 듣기 싫으니까, 나가!	0
어머 그래서요?	5
… 증거는 없는데, 핸드폰 보니까 웬 여자랑 카톡을 하는데… 아주… 가관이더라고.	0
그렇게 마음에 안 들면, 엄마가 청소 좀 해주든가.	6
그 분들은 정신적인 충격이 굉장히 크세요.	2
서점이나 이런 데 있잖아요. 그런데 엄청 가신대요.	5
무슨… 숙제인 것 처럼 말하네.	4
곱게 자란게 뭐야?	1
뭐? 안 돼. 아빠도 싫어하셔.	6
그럼 엄살 부리지말고 다시 한 번 해봅시다!	6
정훈엄마. 간통죄는 폐지됐어요. 괜히 힘빼지 말고 위자료 받고 새 삶 살아요.	3
780만원? 그렇게 많이는 한 번에 못줄 것 같은데.	5
애초에 암인지 아닌지 긴가민가 하다고 했으면, 나도 그런가보다 했겠지.	2
어 예쁘네. 저기가 남해냐?	7
유치원에서 어버이날 선물로 편지 쓴 적 있는데. 그때 엄마 100살에 궁전 지어 줄 거니까 오래 살라고 했던 게 기억 났어.	4
오빠는 엄청 편식 했잖아.	1
"아 왜, 너네 동네에, 저기 좀만 더 들어가면	 버려진 집 있잖아."	6
진희 나가서 산지 얼마나 됐지?	5
 주문하신 음료 나왔습니다.	7
짜식 바쁘구만? 다음에 나오면 미리 연락해. 삼촌이 시간 빼서 맛있는 거 사줄게.	7
지은이 또 뭐 먹었는지 까먹었으면 놀리려고 했는데, 기억 났나 보네.	5
맛도 그래. 여기 할머니 은퇴하신 뒤로는 순대가  이렇게 무른 게, 영 별로야.	1
"안 믿을 걸요? 기말고사 때까지 구박할걸요?  	맨날 아침 먹을 때마다, 누구는 잘 봤드라, 누구는 밤새 공부한다드라. 	생각만해도 체할 거 같애."	2
 근데 아들, 엄마 친구 세연 아줌마 알지?	1
아저씨, 울 엄마랑 사귀냐구요.	6
헐 왜?	5
그래. 그럼 나 오늘 좀 일찍 들어가봐야되겠다.	6
진짜요? 어느 게 더 맛있어요?	5
그래? 그래. 한 학기가 딱 좋아. 거기서 학점 따기도 어렵고.         경험 삼아 한 학기 가는 게 딱 좋지. 여행도 좀 다니고.	5
아니.. 누가 못 들어온다고 했냐구요.. 진짜 도둑이 제발 저린다더니..	3
아… 클났다. 핸드폰도 버스에 있는데…	2
왜긴 일어나라고 패지.. 나 아침에 잘 못 일어나니까	6
 아니. 아빠도 원래 이 시간 쯤에는 집에 계셔야 하는 거 아닌가.	4
내 말이. 그 말 좀 우리 남편한테 가서 해줘라. 다른 집 남편들도 다 그렇게 한다고 나한테 대체 뭐가 불만이녜.	0
너무 안타까우니까 그렇지.	2
아이구. 고맙네 그래	7
귀찮단 말이야. 청소하기도 싫고.	3
대체로 남자들이 그렇다니까. 남의 말을 잘 귀담아 듣지를 않거든.	1
엑셀은 다룰 줄 아시죠?	6
이미 충분히 생각했어. 이번엔 떠날거야. 계속 버텼는데 이제는 진짜로 안 되겠다.	0
헐 어떻게 해.	5
열심히 준비해볼게! 기다리고 있어.	1
어떤 사람이야?	5
네. 맞아요.. 근데 갈수 있을지 모르겠어요. 실기가 너무 많고, 비중이 커서요.	2
" 오늘이 그 날이었구만.	 어때. 잘 들어가셨어?"	4
너는, 너는 나한테 안 그랬냐?	0
 엄마! 저 정말 바쁘다니까요.  그리고 결혼 생각 아직 없다구요.	0
이번에 김부장을, 이사로 승진을 시켜주려고.	1
아니긴 뭘 아니야? 뻔하지.	3
거기서 바닷물을 엄청 마셨구나…	1
그건 나도 똑같은데, 나는 그래도 일어나서 운동은 못하겠던데.	1
뽀뽀? 아니면 키스?	5
무슨 말이길래, 이렇게 서론이 장황하니? 	7
아니.	4
 어. 근데 뭐라고 해야 되? 나 고백 해본 적이 없어.	2
내가 거기까지는 얘기를 못 들어서…. 근데 재하가 잘못했다는 얘기는 들었어.	2
너도 내가 능력없는 구닥다리 같냐?	0
저번에도 버스 늦게 온 적 있었는데, 그 때는 오다가 차가 고장나서 그랬다고 아저씨가 말해줬었어요.	4
미안해 진짜 차가 막혔어.	4
야 이게 세대차이인거야. 노력은 무슨..	3
"둘이 보통 사이였어?	 10년을 만났으면 거의 가족이지.	 어떻게 헤어졌다고,  딱 두부 가르듯이 갈라지냐?"	2
그럼 어쩌라고.	6
어어. 용어집.	1
이번에 아빠 오시면, 여행 가기로 했잖아.	7
아빠한테 다 들었어.. 엄마한테 숨겨진 아들이 또 있다며..	4
삼십만원만… 갑자기 빌려 주기엔 너무 큰 액수인가?	2
그 사람은 니 어디가 마음에 든다냐?	3
엄마 나 잠깐 나갔다올게.	7
어제요? 그냥 애들이랑 집 갔는데요.	6
뭐 대단한 일이길래 말씀드리기가 어려워.         갑자기 이러면 나보고 어떡하라는거야. 은주씨는 책임감이 없어?	0
더 이상 살아갈 의욕이 없다. 직장에서도 짤리고, 만나는 사람도 없고...	6
그럼 한번 시켜봐.	2
그간… 참 많은 생각을 했습니다.	2
형님이 보험 그만 두라고 해서 그만둔거잖아. 그니까 화장품 하나 사달라고요.	4
다른 할머니들?	5
나는 아직도 눈에 선하다. 선해!	2
핸드폰 한 번 바꿔보세요. 제가 후회 안 하게 해드릴게요!	2
응, 내가 술 많이 먹지 말라고 당부를 했는데, 들을런지 모르겠다.	3
친구들한테 현수 나쁜말 하고 그랬어?	2
다음엔 아이스크림 뭐 그런거 먹으러 갈까?	7
아뇨. 저는 공대쪽 교수님은 잘 몰라요.	2
쉬운데. 쉬워서 재밌어요.	5
병가냈다. 와서 앉아봐.	4
네 안녕하세요.	7
아니야, 너 밖에서 이러고 졸면 사람들이 너 진짜 노숙하는 애인줄 안다니까.	2
엄마가 맨날 그래. 고모 무섭다고.	1
아.. 그러니까.. 내가 미안하다고 하잖아.	4
아, 정말 그렇겠네요. 태블릿으로 문서 읽는 거에 좀 더 익숙해져야겠어요.	1
응.	1
어디에요?	5
지난번에 유흥업소 단속 지원 나갈 때 뭐 특별한 일은 없었고?	6
그런 게 아니라. 니가 워낙에 거짓말을 많이 치니까.	6
……. 대학 가야죠.	1
나 일 잘해 엄마. 회사 에이스야.	1
 어.	2
네. 그럼 말씀 드릴게요. 조심해서 가세요.	1
그래서 어떻게 됐어요?	5
그게, 아직 전센데...대출도 많이 껴있긴 한데... 그래도 열심히 모으고 있어!	2
네…? 갑자기 무슨 말씀하시는거에요?	5
응. 그 때쯤엔 배 고프겠다.	7
 학원 끝나고 돌아가는 길.. 편하게 그 날 있었던 일을 말씀해주시면 됩니다.	6
이거보다 맛있을까?	5
아니 흥분하지 말고.	5
내가 잠 깨게 해줄까?	7
그러니까 집중해.	0
그래. 요즘엔 학교 공부도 참 어렵다고 하더라. 경쟁도 심하고.  민지는 나중에 어떤 사람이 될 거니?	4
그거 고가의 물품이고. 배송 지연으로 저희가 영업 손해 봤는데 다 보상해주세요!	0
알았어, 그럼 새거로 하나 사자.	1
있어?	5
왜? 없을 거 같아?	5
아 또 얘기가 왜 그렇게 흘러가요.	0
할머니 카페에서 왜 이렇게 소리를 질러.. 조용히 말해도 되잖아	6
해결사 찌라시?	2
뭐가 이해가 안 가는데?	4
몰라요~ 의미 파악하고 싶지도 않고~ 저 자퇴할거에요.	3
영화과들 입시가 있으니까, 그거에 맞춰서 가르쳐 준대요.	1
양말 같은 데에 허비할 시간 없다~ 얼른 아무 거나 신고 가.	3
엄마 저번에 넘어진 데는 좀 괜찮아? 발목은 다치면 오래가잖아.	4
아냐. 커피 한 잔 정도는 내가 살 수 있지.	1
"제대로 안하는게 뭐가 있어요? 제발 좀 아들래미 말 좀 믿어요 좀. 	 노인네가 귀는 얇아가지고 사기꾼 말을 왜 이렇게 쉽게 믿어요."	0
아. 그 심장외과의?	1
다 티나.	6
저는 더 이상은 말하기가 힘들어요.	2
그걸로 못 사.	1
"할아버지가 지금 누나 혼내면, 	집에가면 누나가 저 죽일거에요."	2
나 진짜 진지해.	6
일 년이나 같이 살았어? 근데 왜 헤어졌어. 너희 대학 때부터 cc 아니었어? 몇 년이나 만났지?	3
티비에서 보니까, 매니큐어를 하던데. 저도 하고 싶어요.	5
네… 근데 그때 이후로 제가 진짜 메일 신경써서 보내고 있거든요.	2
그러니까. 사람은 사람으로 잊는 거라고. 넌 그런 말도 모르냐?	0
아니, 노인들을 이렇게 불러다 놓고. 벌써 열한신데 집은 언제 보낼려고 그러는거야.	0
그게 니 맘대로 될 거 같아? 아빠도 술을 마시고 싶어서 마시는 게 아니야. 사회가 아빠를 저렇게 만드는 거지. 알코올에 쩔지 않고서는 견딜 수 없게.	3
너 저녁 먹기 전에 이렇게 단 거 많이 먹으면 못 써 밥맛 없어져	6
얼마나 먹은거야?	1
아우.. 그래도 좀 정도껏해야지. 수업을 너무 못해. 졸려서 참느라 혼났다고.	6
쌍커플하고 턱.	5
이번 교내 백일장에서 도진이 네가 쓴 글이 장원으로 뽑혔더라.. 평소에 글 쓰는 데에 관심이 많니?	7
응. 적어도 나는 그렇게 생각하고 쓰고 있어.	1
말만이라도 기분이 좋네.	7
이게 진짜… 말하는 꼬락서니 봐. 야! 막말로, 백수가 집이 뭐가 필요해. 어?	3
그랬으면 너가 목도 훨씬 길어지고 자세도 훨씬 좋았을 거 아니야.	6
"그런 거 함부로 따라가는 거 아니야.	 빈 자리 있다고, 그런 거 따라 갔다가  같이 저 세상 가는 거야."	2
그거 장가는 제대로 가려나 몰라.	2
"그 사이로 바람이 불어오는데, 가을인거야. 	분명 전 날까지는 여름이었는데. 하늘도 공기 냄새도. 	그냥 자고 일어났는데 가을이 됐어."	7
좋은 점은, 이제 상대방을 아주 잘 안다는 것?	2
그럼 내가 싫다고 하면, 엄마랑 헤어질 거에요?	6
음식을 가리지도 않아!	1
그러니까. 너 뭐 짐작 가는 애 없냐?	0
네? 왜..요?	2
근데, 어차피 엄마가 고모 이기잖아?	1
무서우면 안 보면 되지, 왜 그걸 굳이 찾아서까지 보는 거냐.	0
안돼. 머리띠 해야 돼.	0
"에이. 나 그렇게 좋은 사람 아닌데. 나 너한테만 잘해주는거야. 	내가 너 좋아하니까."	7
어떡해요 그럼… 저도 결혼 파토나고, 회사 짤리고, 요새 진짜 뭐 되는게 없어요.	4
하... 대박이다 진짜	3
"그건, 조카가 이기고 있어서 	 기뻐서 그런 거지!"	6
"엄마는 후회 안해. 	 너한테 가끔 미안하지."	2
있어! 남자는 그런 거야!	3
왜?	5
진짜라니까? 내가 다음에, 우리집에 있는 UFO 관련 책들 다 보여줄게.       거기 보면, 2030년에 거대한 UFO가 지구에 찾아올거래.	3
아. 네. 제가 이번에 전세 들어오기로 했어요.	1
 짜증나.	6
많이… 나쁘셨을 것 같습니다.	2
그럼 아주머니, 제가 이거 드릴게요.        	2
아… 5분밖에 안 늦었잖아요.	3
아. 응. 지연이네 할머니 나이 많으셔. 할머니랑 달라보여.	2
많이 아픈거니? 어쩌다 이랬어.	5
그래? 요즘 애들이 공부할 때 그렇게 긴장을 많이 하면서 한단말이야? 나는 몰랐네. 그냥 공부할 때 자세가 안좋아서 그런 줄 알았는데…	4
퇴직금 있잖아. 꽤 될 거 아니야.	0
학원 앞 골목에???	3
그래? 아버지가 무슨 회사 하시는데?	5
 네. 엄청요.	4
스트리머가 무슨 진짜 직업인 것처럼 말하네.	6
너를 엄-청 엄청 사랑한다는 거야	7
"엄마가 너한테 할 말이 있는데, 	언제 얘기할지 계속 고민하고 있었거든."	2
음… 너는 몰라도 돼.	7
아 맞다. 우리 이름 써야지.	5
"나갔구만 나갔어. 모르긴 뭘 몰라요.	 아이구. 내가 제 명에 못 살지."	6
정말 너무하네 엄마. 아니 할머니 이렇게 정정한데, 무슨 요양원이야.	6
 1등은 늘 걔가 했다니까….	7
아버지가 따로 있지. 우리 엄마랑 결혼 했다고 당신이 내 아버지가 되는게 말이 됩니까?	0
어? 왜요?	5
니꺼, 니꺼 있는데 왜 맨날 내꺼 쓰냐?	0
 예. 요즘엔 다 그렇게 하죠. 생화는 워낙 비싸서요.	7
그 남자앤 어때? 언니 마음에 들어?	5
애들이 막 깔깔거리면서 놀렸는데... 아마 지금은 화장실에 갔을 거예요.	4
오래 된 집에 크랙 하나 없는 데가 어딨어요.  바닥도 싹 하고 들어올 거 아니야? 공사하믄 말짱해요.	3
우리 아저씨 상태가 많이 안 좋아졌다는게 무슨 말이에요?	3
매장 정리하고, 문단속 하는 거, 그게 마감이랜다.	6
아… 야, 너 그럼 그 오백 나한테 맡기고, 그냥 우리집 와서 지낼래?	2
그래서, 아빠는 성공했대요?	2
니가 손녀니까.	2
 뭐 그냥 그런 것 같아요.	6
뭐가 웃겨요? 지금 웃음이 나요?	0
저, 오늘 봉사 하기로 한 명지원이라고 하는데요.	2
"그거야 니가 집에 있으니까 부른 거지.	 동네 술집들도 명절이라고 싹 다 닫은 판에,	 넌 왜 여기 있냔 말이야.  본가 안 가?"	6
봐봐.	1
아유, 영재 엄마! 섭섭하려구 그러네. 우리 사이에, 뭐 용건이 있어야만 만나구 하는 건 아니잖어.	4
네. 죄송해요 선생님. 아무튼 그래서 제가 그 놈들 다 한 대씩 패줬어요.        사진도 삭제하고요.	6
아시잖아요. 저는 마음이 여려서 경영 이런 거 못해요.	6
너도 참 너다.	5
….. 네?	3
"그래. 근데 거기 매니저 맡아주기로 한 친구가 사정 때문에 일을 못하겠다고 하네?	 그래서 준우 니가 거길 좀 맡아주면 어떨까 싶은데..."	6
선생님. 선생님은 면허 언제 따셨어요?	1
응. 내가 해결할 수 있어. 걱정하지마.	7
선생님은 맨날 농사 짓지 말라고 그래. 그러니까 여기 오기가 싫어요.	4
아 기분 다 잡쳤네.	3
과외 하느라 학원 갈 시간이 없었겠지.	6
예진쌤네 반 애들은 워낙 얌전해서, 수학여행 가서도 사고치는 애들 없을 것 같아. 다들 점잖잖아 애들이.	4
아아~~ 아직 안 끝났어~~~	6
누가요? 누가 그런 모함을 해요? 어두워서 잘못 본 거 아닐까요?	0
얘가. 빨리 안 갖고 와? 너 이번에도 성적 떨어지면 엄마가 특별 과외 붙여준다고 했지? 성적을 봐야 과외를 할지 그냥 그대로 둘지 결정을 할 거 아냐.	0
왜?	5
아 네.	6
입술 색깔 봐라. 무슨 쥐 잡아 먹은 것 마냥.	3
엄마가 뻥친거야. 나 안 그랬어.	4
팔천 팔백. 맞는데. 그건 해수면에서 높이를 잰 거고, 키가 제일 높은 산은 하와이의 마우나케아 야.	1
"왜긴. 그 용돈이 채널 수익에서 나오던 건데,	 영상을 안 올리면 이제 그 돈이 안 나오지."	6
가만 있어. 엄마가 더 좋은 선생님 붙여줄게.	0
힌트요?	5
아니에요.. 제말이 맞다니까요? 오히려 잘 만큼 자고 푹.. 자고 일어나서 공부하는 게 더 좋죠. 맑은 머리로.	3
 어떻게 그래요? 선생님은 누구 좋아해본 적 없어요?	6
그럼 나도 안 사줘.	0
학교를 다녀서 좋은게 뭐가 있어요?	3
종일 땡볕에서 놀기나 하고, 지저분하고, 차분하지 못하고 덜렁댈 것 같다구.	3
야… 니가 제보할 게 있다고 해서 내가 학교까지 찾아왔더니… 너 나한테 왜 이래?	0
범인을 못 잡았어??	3
그럼 어떻게 해야 할까요? 뭐든 할게요.	2
어쩌긴 뭘 어째. 회사에 확 불질러버려야지.	6
날? 자기야… 나 때릴 데가 어딨다고…	5
삼촌!	7
형. 형도 수염나?	1
네. 백업용 카메라 하나만 클라우드에 연동되어 있었던 거라…	1
내가 그냥 셀카 찍으려다가… 조금 찍혔을 수는 있어…	2
암튼, 쓸 데 없는 거 궁금해하지 말고. 수업준비나 해.        숙제는 했냐?	7
자꾸 삼촌 생각 나서…	4
아...	6
노키즈존이라고 해서 어린애들을 못 들어가게 하는 가게들이 있대.	4
근데 그게 우리 회사에 맞냐는거지.. 주로 개인 업무 위주로 돌아가는 회사에서 파티션을 다 떼버리고 서로 책상을 훤히 들여다 볼 수 있게 됐으니..	0
고작 한…마리요?	3
 걔가 먼저 저 놀렸단 말이에요.	0
저 사거리까지 갔다가 얼마나 돌아다녔는 줄 아세요!	0
동아리에는... 이번에 1학년 후배들 새로 들어왔지?	1
그게 뭐야.	4
응... 요즘 취직이 어렵다면서...	4
네? 아니.. 제가 어떻게 그렇게 큰 액수를…         한 번만 봐주십시오 사모님.	4
어. 근데 우리가 가면 맨날 먹는 메뉴가 있단 말이야.	1
어머, 얘 어린 애가 말하는 것 좀 봐. 그 엄마에 그 아들이네.	0
아 진짜에요.  그리고 이 손 놓으세요!	3
그래, 아무래도 우리가 이공계관련 수업에 있어서는 좀.. 특화되어 있는 편은 아니니까.	2
아 몰라요..	3
누나한테 언제까지 숨기시려고요?	2
 어? 어… 누나 남자친구.	5
그래. 이번에 다시 기회를 줘 보자. 내가 함 말해볼게.	2
감사합니다.	1
인터넷? 인터넷 들어가서 보고 싶은 게 뭔데?	5
아.. 어린이는 커피를 마시면 몸에 안 좋아요	4
아.. 그럼 제가 할까요? 지금 당장 하는게 좋을까요?	2
알죠~ 감사해요.	7
처음에는 죽고 싶지 않았어. 다 죽이고 싶었지. 나를 쫓아낸 회사 인간들도, 애매하게 양다리 걸치다가 나보다 더 잘 사는 남자 선택한 그 여자도. 그런데 다 죽여 버리기엔 내가 너무 무력한 거야. 그래서 결심했지. 그냥 내가 죽자.	6
어.. 사형을 구형할 만 했다고 생각합니다.	2
생리 여전히 없으시죠?	1
100이요? 아니 무슨 꽃다발이 그렇게 비싸요?	5
얼마나 가야 돼요? 여기서 먼가요?	2
뭐가.	7
네 부탁드립니다. 마지막으로 한번만…  용서해 주십시요. 죄송합니다.	4
 엄마는 나 아픈 것도 안아프다고 하고 나를 못믿어? 진짜 짜증나…	0
응응.. 거기까진 나도 알아	7
참 나… 진짜 걔도 웃기는 애네요. CCTV에 증거가 떡하니 있는데도 그래요?	3
그러게, 요즘  젊은 얘들은 안 참잖아.	1
손? 아까 들어와서 씻었어.	1
잘못 했지?	7
아, 혹시 동남아 쪽으로 가는 것도 있나요?	5
왕빈? 진짜로? 실제로 봤어?	5
야, 청소한지 일주일이나 지난 거면 엄청 많이 지난 거지. 너 스스로의 위생 관념에 대해서도 좀 돌아봐야 할 때가 아닌가 싶은데?	0
완전.	7
왜.	5
다른 애들은 남의 집 자식이니까 모르겠고, 너는 맨날 봐야되잖니.	3
그냥 멀리서 지켜만 봤지. 하교 시간 맞춰서 나도 같이 하교하고.	4
내가 우리 가족들을 위해 열심히 일하고 있다는 자부심!	7
하….	0
미안해...	4
 네…	2
뭘 농담이야! 잘 다니던 회사 내가 관두고 싶어서 관뒀냐? 니가 동거하자고, 같이 살아만 주면 생활비 알아서 다 해결하겠다고 해서 관둔거 아니야!	0
뭐???	6
그래. 예쁘고 귀엽네.	0
신선한 원두 쓰고, 맛있게 하려고 커피 공부도 많이 하구요.	7
최선을 다하겠습니다.	2
다 받아주는데가 있어. 그만큼 열악하겠지만.	4
너무 푼돈 이야.	4
누나, 요즘 애들은 안 그래. 예서도 이제 성인인데 지들이 알아서 하게 내버려 둬 좀.	7
네?	5
에고... 희순이랑 왜 싸웠어? 제일 친한 친군데.	4
내가 뭘 또 그렇게 무관심했다고 그래?	6
어어 지금 벌써 나가야 할 시간인데 이제 일어나서 어떡해 진짜… 이게 다 할머니 때문이야!!	6
네.	1
그냥 대충 그려 대충. 너가 괜히 잘 그리려고 하니까 오래 걸리지!	1
응. 형은 전기 면도기 써.	1
그래야 되나? 아…. 평소에는 약이면 되긴 했는데. 면역 생긴건가?	2
다 풀었는데.. 잃어버렸어요.	4
자기 좀 쳐도 돼?	0
예. 근데 벌써 남친이 있다더라고요.	6
아유 잘먹었다. 이렇게 아무렇게나 한 끼 사 먹으면 되지, 맨날 뭘 해 달래 해 달라기는. 귀찮게.	3
너, 그 선생님 예뻐서 바꾸기 싫은건 아니고?	3
성훈아 공부도 꼭 잘할 필요가 없어.	1
그럴까. 우리 딸도 서희 씨 반만 닮음 좋았을걸.           얘는 워낙 붙임성이 없어.	4
"아이고, 첫 명절이라고 너무 들떴구만.	 얼른 불러. 처가 와서 정신을 바짝 들게 해줘야지."	6
형이 한 두번 나를 속였어야지!	0
괜찮네?	1
진짜 어이가 없어서…	3
정말 죄송한데… 제가 진짜 뭐든 꾹 참고 일 할 수 있는 사람이거든요? 근데… 진짜 쥐만큼은 안돼요. 못 참아요!	3
말조심해라. 쳐마시다니. 어제 한 두 병밖에 안 마셨는데…	0
전세 자금 보태달라고 협박할 때 당신이 그랬잖수.	3
응, 지은이 할머니라고 해서 지은이 이름이 뜨는 거니까 걱정하지 마. 의사랑 간호사 선생님들이 헷갈리지 않게 잘 해주실 거니까.	1
자주 가십니까?	5
탄산수도 한 박스 사다 놔야겠어.. 지훈이가 다 마셨더라고.	1
백구요? 백구 엄청 귀여웠는데…	4
잘 지낼거야. 좋은 업자한테 팔았으니까.	2
내가 더럽고 치사해서 이제 안 입는다!	0
뭐하려고 해요?	1
할아버지가 옛날사람이면 얼마나 옛날사람이라고! 더 어른들도 고양이 잘 만 돌보거든? 괜히 할아버지가 고양이 싫으니까 핑계나 대고… 나빴어!	0
그니까요. 근데 대학 못 가면요? 대학 못 가면..         초등학교 때부터 지금까지의 제 인생은 뭐가 남나요.	6
뭐? 우리 사위가 밖으로 나돌 사람이라는거야?	0
기특하네 우리 아들. 근데 엄마는 우리 준영이가 건강하기만 해도 좋아.	7
중고차라도~ 이모 힘으로 산건데~ 대단하다!	7
 당연히 생리가 없으시죠. 애가 들어섰는데요.	1
무슨 계약서?	5
민지 너, 어제 자기 전에 양치 하라고 했지. 했어?	0
"어쩐지, 전기세가 많이 나오더라. 	집에서 노는 사람이 겁도 없이 에어컨을 이렇게…"	0
왜?	5
상한 음식 팔아서, 우리 애 입원시킨 걸로요!	0
으이구. 지금 얼마 있어?	0
김칫국도 작작 잡숴야지. 그러다 목 멕혀 죽어.	3
그냥 유선이어폰 써. 니가 무슨 블루투스 이어폰이야.	3
저는 몰랐죠. 수원이면 가깝네요. 아침 먹고 바로 출발할까요?	4
아 내가 그런 책을 빌렸었나?	5
버... 버블버블이 뭔데??	3
아, 이런건 옛날에 학교에서 다 배웠지. 아무튼 계속 들어봐.	1
더 맛있는 거 뭐?	5
맞아요.. 알고보니까 세정이도 저를 오해하고 있더라고요.	4
우리 수영장에 나오는 여학생 하나 있어.	1
아 진짜 아쉽다. 부러우니까 오늘 술은 니가 사라.	7
응.	7
지훈아 뭐해?	7
삶이 다 그런 거란다. 즐거운 일만 늘 있을 수는 없잖아.	4
그래도, 지금은 아직 학생이란 말이네?	6
그럼 먹으면 안 되겠네…. 근데 너무 맛있는데.	5
아부지 줄담배 피잖어. 그런데도 아직도 폐병 안 걸린게 용하셔.	2
네? 네.	5
 네? 저요?	5
하…	0
그런데 그 집은 할머니가 거의 혼자 일하시는 모양이더라구. 그래서 조금 시간도 걸리고, 마무리도 깔끔하게 해주시려나 걱정이야.	2
언니. 일어나.	0
뭐? 너 지금 뭐라고 했어?	0
���� ���࿡ �ֿ� ������ Ű��ٸ� �������� ���� �� ����, �����̰� ���� �� ����?	7
그 아빠 목소리처럼 변하는 거.	2
감기는 아니야. 그냥 자꾸 마른 기침이 나.	6
그 가닥이 남아서 그런지, 진짜 빠르게 느는 것 같아.	5
우와 어떤거 촬영 하셨어요?	5
… 아.. 아니에요.. 아빠. 죄송해요. 제가 학원 땡땡이 친거였어요.	2
그래. 착하다 우리 딸.	7
그래. 돈 없다 쳐. 내가 뭐 비싼거 사달랬어? 바디로션 사달라는게 그게.. 무리한 부탁이냐? 너 어제 보니까 친구들이랑 술은 또 엄청 마셨더만.	0
여러가지 이유가 있지.	3
누나 혹시 주변에 아는 사람의 아는 사람 없어?	1
하긴 바지가 더 정확하겠지.	1
뭔데 그래?	0
엄마 아빠 결혼사진에 내가 왜 있어?	2
뭐 하냐.	6
그 여자. 내가 상대가 안돼.	4
허…	3
지난 번 방문 때에 비하면 훨씬 안정되고 차분해졌어요. 다만 대화할 때 상대방의 눈을 제대로 바라보지 못하고 동공을 이리저리 움직인다거나, 쉴 새 없이 손가락으로 팔뚝을 꼬집는 행동은 차차 고쳐나가야 할 것 같아요.	6
모르겠는데요?	6
그렇기는 하지. 그래도 여기저기, 새로 생기는 가게들 보면 전부 다 카페니까. 동네에 소소한 철물점이나 세탁소 같은 가게들이 점점 사라지고. 죄다 카페로 바뀌잖아.	4
엄마가 싼 건 싫어?	5
맞아 그니까 그 집 애들이 뭘 보고 자라겠어	6
아직 모르셔.	4
태국여행이요?  그건 좀 빡센데. 아버지 혼자              가시는 건 아닐 거잖아요?	5
오~ 너 이번에는 진짜 마음 먹었나보다? 무슨 일이라도 있었어?	7
아니, 왜 알바생한테 그렇게까지 친절해?	3
저도 그렇게 해봐야겠어요. 근데 일하고 나면 배가 너무 고파요.       자제가 안 돼요. 자제가.	7
그래? 그럼 조금 더 싼 걸로 바꿔볼래?	5
아 선생님~ 자퇴 하다가 졸업하겠어요 아주~	3
영화과 나오셨네요.	5
아.. 진짜 꼰대들 짜증나네...	3
니가 남의 물건 함부로 손대놓고.. 뭘 잘 했다고 그래? 어?	0
아.. 첫 스마트폰에.. 그런 모양이 있었던거 같아!	2
 너 걔 좋아하냐?	5
너 고양이 만질 수 있어?	5
엄마랑 아빠랑, 따로 산다고 해도….	4
무슨 학원인데?	5
그래, 선생님도 도진이 너한테 기대가 크다.	7
그래, 아픈 건 질색이야.	0
어. 그래야겠어. 경훤이 가져가라고 해.  자도 피로도 안 풀리고. 난 수건 자고 자는 게 더 편한 거 같아.	7
니 할머니가 여태까지 힘들었다고 하더라.	0
먹통이라고요! 노트북!	0
안 내셨으니까 선배님이 13페이지까지 하세요.	1
여기 서울에 있는 친구들 어떡하고?	5
나 너 성적표 봤다?	1
아니 오빠, 요즘 들어 갑자기 먹는 양이 확 늘었어. 무슨 겨울잠 자려고 준비하는 곰마냥 먹어대잖아.	5
그래, 그래! 내가 허투루 살지 않았구나 싶었다니까.	1
엄청 좋지. 근데 벌레가 많아.	3
지호, 얼른 연습을 해야, 확인받고 집에 가지.	0
왜 그 상가에 복도 청소를 다같이 하잖아. 근데 그걸 글쎄 쏙 빠지겠다지 뭐야.	0
그때 우리 옆집에 살던 애였는데, 걔가 감자를 데려가고 싶다고 울고 불고 난리를 피워서, 결국 걔네한테 감자를 뺏겼어.	4
�� ������.	1
지금! 안 나오게 생겼냐	0
 아 아니에요 아무것도..	4
아니면 시켜먹을까?	2
이봐. 찔리니까 말 더듬네. 빨리 내놔. 경찰 부르기 전에.	0
왜? 안그래도 그 할머니가 자기 손녀딸이 친구 없다고 엄청 걱정하더라. 민지한테 무슨 일이 있었어? 왜 친구들이 안 놀아줘?	2
엄마. 오늘 저녁 뭐야?	7
응. 그러면 할머니가 치킨 사줘.	1
응. 근데 엄마. 나는 진짜 이제 못 참겠어.	6
 나도 알아. 스트레스 주지 마.	6
아.. 아니 그게 아니라.. 저 제 2금융권 대출 있단말이에요 신용불량자 되는거 금방이라고요.	2
비싼 거 마셔도 되는데.	1
너 지금 결혼했다고 유세떠냐?	6
귀신 안믿는다며?	3
 형 있잖아요.	2
….너….나 사랑하긴 하니?	6
왜 그래, 지은아. 무슨 일 있어? 왜 이렇게 달려오는 거야?	5
 네네.	0
아줌마~ 저 참치 김밥 하나만 포장해주세요.	1
그치만 자꾸 치킨이 눈앞에 아른거린단 말이야.	6
엄마 우리만 보고 사셨지.	4
뭐야. 니네 남편 뚱뚱하잖아.	0
잠깐만요. 이것만 다 하고.	6
그랬는데, 없어. 티비에 없어.	4
지겹지도 않니?	3
삼촌 그거 이어폰.   짝퉁이잖아!	0
 이거 어머, 이거 맛이 원래 이러니?	3
뛰지 말라고...	2
" 진짜???	 언제 와? 언제 오는데?"	7
아… 진짜 누나 내가…	2
그럽시다.  근데, 이게 무슨 냄새지?	6
네 교수님.	2
 뭐하니 너?	5
나도 알아.	4
혼은 안났어?	2
너, 용돈 올려 주기로 한 거 취소야!	0
알았다. 알았어. 잔소리는 니 형수로도 충분하니까 그만해라.	6
나도 다른 사람들 다 간 줄 알고 뒷정리하다가 화장실에 들어갔는데.. 어떤 사람이 쓰러져 있어서 얼마나 놀랐는지 몰라.. 꿈에 나올까 겁나는 광경이었는데… 암튼 그 사람이 왜?	3
니가 살이 어디가 쪘니. 손목은 이렇게 뼈밖에 없는데.	4
아니.. 어차피 알바도 거기 가려고 한 거에요..	0
어? 없어요?	2
아니에요. 전 절대 안 잊어요.	0
딸 와봐.	7
고모… 아빠가 애에요? 아빠가 지금 유치원생이에요? 그리고.. 아빠가 엄마한테 어떻게 조종을 당해요? 뭐든 아빠는 아빠 맘대로만 하는데?	0
그래. 우리 집안에 박사가 나오겠구나.	7
어. 너도 이빨 썩어서 왔어?	4
그럼 구해주러 가자!	1
"응! 그 형! 그 형이 여자친구랑 	하루에 한 번? 아니면 두 번씩! 한 시간 정도, 영상통화를 한대."	7
하여간 박여사 까다로워.	1
왜? 생기면 좋지.	5
치… 할아버지는 엄마 편만 들고!        할아버지는 동생 없어요?	6
엉. 그거 어쨌어?	0
아 누구한테 전화를 해! 엄마가 선도부한테 전화해줄거야??	3
뭐?	5
네 오늘 어떻게 오셨나요.	1
왜?	5
왜 둘한테 무슨 일 있어? 둘 다 잘 지내고 있는 거 아니었어?	5
어떤 일로 오셨죠?	7
그래. 거기 좋지.	7
가격차이 감안하면 정말 굉장한 걸?	1
너 이런 식으로 자영업자 겁박하고.. 니가 아직 세상을 몰라서 그래!	0
남팬들은 돈을 안 쓰니까 실속이 없지.	1
"내가 왜 몰라! 나는 아무에게나 내 시간을 몰빵하지 않아!	 대성할 새싹들에게만 올인하지."	7
너는 어른한테 그렇게 밖에 말을 못하니? 그리고! 니가 잘 했으면 내가 이렇게 말 하겠어?	0
 어휴, 어떡해 정말. 20층 올라오느라 진땀을 뺐어, 아주~~	3
그래. 다음 주 중에 내가 한 번 찾아 갈게.	1
요즘에는 맘 편하게 일용직 선호하시는 분들이 더 많으신데 특이하시네.	5
너무 다그치지 말고 기다려 봅시다.	3
엄마가 잠깐 화장실 간다고 해서 기다리고 있어요. 아줌마는 누구에요?	1
다음 주부터 부동산 보러 다녀야 돼. 운전해 줘야지.	3
하고 싶은게 없어?	1
나리 불쌍해….	6
많이 주긴! 엄청 짜!	6
큰일났다 이제.	3
근데 교수님은 책 한 달에 몇 권 정도 보세요?	1
뭐하느라 바쁜데?	3
 여기.	7
그렇게 해야 다 치우는건줄 알고.. 정말 죄송합니다..	4
별 거 아니네. 난 또 뭐 특별한 걸 주는 줄 알았지.	3
그래. 알았어.	7
지금 세훈이 일이 좀 심각합니다.	3
무서운 영화? 그런걸 왜 봤어?	6
아빠 요리 못 하잖아요…	3
무슨 술집?	5
철딱서니 없다니! 이 향수도 마누라가 사준 거라고.	0
그랬구나. 이번에 문제 난이도가 좀 있었나보네.	5
음... 글쎄... 안 세봤어.	7
감사합니다,	7
나, 평창동에 집 있었잖아. 그거, 팔려고 내놨어.	4
에휴. 그래. 그럼 뭐 먹고 싶은데. 또 피자?	3
"일부러 들으려고 한 건 아닌데, 	혹시 우는건가 싶어서… 혹시 여자친구랑 헤어졌나 싶고."	4
"아...예진씨 오면 같이 말하려고 했는데.	 응. 아저씨 오늘 나윤이한테 허락받으러 온 거야."	2
그 때 맨날 삼촌이 늙었다 늙었다 하셨었는데.	4
쪼끄만 게. 말하는 것 좀 봐. 그게 무슨 밴데.	0
그래도 한 시간이면 숨도 차고 힘들텐데.	1
아니야, 내가 뭘 잘못 만졌다고 그래. 그냥 가만히 인터넷 하는 중이었다니까.	6
식도염이요?	5
지금 우리 이렇게 대화하고 있는거… 상철 씨도 아세요..?	1
" 어...아저씨?	 어... 그게... 아저씬...엄마 친구..야!"	2
그렇겠죠… 타이밍 벨트도 큰 맘 먹고 교체 했는데…	4
 그거 분리수거 해야 돼.	4
아마 그럴 걸? 전에 아빠 차에 내 동생이 매직으로 낙서한 적이 있거든?	1
왜?	5
아니요, 나머지도 제가 금방 마련해서 드리겠습니다..	2
정말? 그럼 안 할래.	5
아 또 공부공부! 엄마는 공부밖에 몰라?	0
"막 머리도 쓰담고, 팔도 만지고, 	저번에는 허벅지도 만지고…"	4
너무 애쓰지 마. 그냥 너처럼 행동해.	7
진짜 제대로 찾아봤어요. 수사권 조정이나 빨리 어떻게 좀 해주세요.	6
나도 교회 나간지 오래 됐는데… 이번 주엔 나가봐야겠어. 너무 황망한 일이 생기니까.. 문득 기도할 데가 생각나네..	1
언니한테 알게 하고 싶지 않았는데…	4
친구들을 꼭 학교에서만 만나야돼요?	3
매일 만원 씩 준다고 쓰면 되려나? 뭐 써넣지? 생각 좀 해봐.	1
아 뭐야! 치사해!	0
물론 계산기가 빠르긴 하지만, 그래도 사람이 머릿속으로 지도를 그려야 계산기가 그 지도를 따라서 길을 찾아갈 수 있는거야.	0
그래. 김씨가 매일같이 동네 산책하고 그랬지.	4
그래. 아이 착해라.	7
어차피 맥주만큼 물 타면서…	3
네.  여기서 보시게요?	3
사이트에 올려놨던 하이폰 식스 에스구요 십오만원입니다	4
뭔데..?	5
손은 씻어야지… 형 금방 올게 알았지?	4
우유! 아기니까 우유 마시지 않을까?	1
엄마가 다 버니까 아빠가 자꾸 자존심 상하나보지.	0
어떻게?	7
아? 저기 새로 생긴 제과점에서 파는 과자인가보네?	1
"그런 건 또 언제 보셨다냐. 	그냥 속이 더부룩해서 간단하게 먹은건데."	6
 아 요즘 공기 왜 이러나 몰라.	4
그래도… 거기서 봐줄 수도 있잖아요. 저 이번에 이 시험 못 보면         면접도 못 본단 말이에요. 아저씨가 제 인생 책임질거에요?	2
"새고 빠진 게 남잔데, 	당연히 좋은 사람 있지. 	걱정하지 말어."	3
나도 그런 줄 알았거든? 근데 그게 돈 받고 하는 거라던데. 일당이 꽤 쏠쏠하다네.	3
 왜?	4
아 이거 큰 일이네. 중국 건은 빨리 마무리를 지어야 되는데.	2
이놈아 장난이지. 할머니 바빠서 안돼.	7
미리 공부해 봐야겠다.	1
아이스죠?	1
준영이도 너희 아빠 닮아서 키가 엄청 클 모양이네.	7
속독은 아니고. 그냥 읽는 건데.	1
민희한테 말 걸어봤어! 복도에서!	1
그쵸? 어쩜 좋죠? 제가 가끔이래요…	2
한 … 열 잔? 어떡해요… 임산부도 계셨는데…	2
아줌마도 너무 놀라서 지금 말을 못하고 있대..	4
아니 지금 아빠가 하는 말이 어른이 하는 말 같지가 않으니까 그렇지. 다 큰 할아버지가 되어가지고 누가 자기를 어떻게 챙겨주나 만 생각하고 있는 게 너무 어린아이 같잖아.	3
너 이따가 안 나가니? 나가는 길에 좀 맡겨주라. 아무래도 내가 가는 것보단 너가 가는게 좋은 것 같은데.	2
그니까.. 좀 먹으면 안돼? 너 엄청 예뻐 세상에서 제일 예뻐	7
" 니 마음이 제일 중요한데, 	그래도 내 마음은 조금만 생각해줘. 	나한테 너무 나쁘게 하지 말아줘."	7
네 말씀해주세요.	2
"니 실력과 외모라면 재민아, 	 제작자들이 눈이 삐꾸가 아니고서야 안 뽑을리가 없어."	7
예. 부탁드립니다. 사람 하나 살린다 생각하고, 도와주십쇼.	2
"만약 제가 갖다 놓기 전에,	 선생님이 알려주고 싶은 얘기가 있으면 어떡해요?"	2
네.	1
다 큰 애가 무슨 거미를 무서워해? 그리고 거미를 왜 죽이니.          거미가 얼마나 좋은 동물인데. 모기도 잡아먹고, 개미도 잡아먹고.         아주 해충을 다 없애주는데. 얼마나 고마워.	6
내 아들 친구여?	5
아 그런가.. 따로 사드려야 하나.	1
물은 어떻게 올려야 하는데요?	5
선생님 저 책읽다가 어려운 구절 나와서 가져왔어요.	1
어. 그래서? 어떤 꿈을 꾼 거야?	2
야… 어떻게 절대 얘길 안해… 너랑, 지금 너랑 얘기하고 나면 상부에 보고도 해야 되는데… 너 경찰이 뭔지 몰라? 경찰들은 서로 협조하고 같이 일하고 그러는거야. 영화나 드라마도 안 봤어?	0
뭐야… 지금 알았네. 나는 평생 엄마가 그 집 미역국 좋아하는 줄 알았어.	5
네.	2
무슨 그런 유리멘탈로 예술을 한다고… 내가 이력서를 자세히 안 보긴했지만서도, 안봐도 알 거 같아. 유치하고, 지만 아는 그런 영화 찍었겠지.	0
알았어. 내가 무슨 눈치도 없는 줄 알아?	0
캐턱? 그냥 문자로 해 문자로 해도 충분하다	6
아빠가 뭔 고생을 했어….. 정작 그 학교 다니느라 생고생하는 사람은 난데 아빠가 뭔 고생을 했냐고.	3
나도 우리 사이가 좋은 줄 알았는데, 그게 아니었나보더라.        와이프는 쌓인 게 많았나봐. 내가 애들 아플 때 옆에 없어줬던 거.        임신했을 때 소홀하게 대했던거. 우리 어머니랑 싸울 때 와이프 편 안 들어준 거.	6
응? 그냥 뭐 잘 썼다고 엄청 칭찬해주는 거지.	1
이철성씨?	1
어. 삼촌이 추천하고 싶은 메뉴가 있어. 아포카토라고 바닐라 아이스크림에 에스프레소를 더 한 음료인데 정말 맛있어. 기다리고 있어봐 삼촌이 사 올게.	7
네.  너무너무 무서웠어요.        그리고 그 가면 쓴 애들이 막 저한테 달려들어서       팔을 잡아당기고, 옷을 벗기려고 했어요.	2
 네. 할 일이 좀 남아서요.	1
에휴… 그래 해봐라, 해봐.	1
 밥 먹으러 가자.	4
"날이 좋으면 날이 좋아서 하기 싫고, 	날이 안 좋으면 날이 안 좋아서 하기 싫고!"	6
아이. 우리 진수 친구인데 당연히 해줘야지. 인터뷰인가 뭔가. 빨리 해버리자고.	7
아니, 모래가 이렇게 밟히는데도?	6
가봐. 얼른!	6
그래서 다른 유명한 무당을 찾아가서 상담을 받기로 했어.	2
아뇨. 잘 모릅니다.	5
"그거는 내가 어떻게 해줄 수 있는게 아니에요. 	집주인하고 얘기 해봐야 될 것 같은데."	6
불안하네.. 항상 자리에 안 계시니까..	2
아… 맘에 안 드는 구나… 거기 영수증 있어. 뭐, 현금 결제했으니까. 교환이나 환불될 거야.	4
첫술에 배부를 수 있나? 다 그렇게 느는거지.	1
핸드폰 있으면 엄청 편하겠다.	1
응. 나는 집이 엄청 가깝거든.	1
했어요.	4
뭐의 약자지?	5
할아버지 건강 생각해서라도 참으세요. 어떻게 저보다 단 걸 더 좋아하세요? 어른이?	3
엄마 진짜 화낸다. 그만해.	0
수사 들어간다니 준비하세요.	2
그래요? 둘 다 괜찮은 거에요?	2
자주 좀 들어와. 엄마 돌아가시고 아빠가 엄청 적적해 하셔.  일주일에 한 번은 언니 찾는 거 같다.	6
" 됐어.	 그 말이 더 비참하다. 조카한테 여자 소개받는 삼촌이라니."	4
근데… 좀 비싼 거야.	2
오랜만이네.. 잘 지냈어?	2
아, 치… 진짜 서운하다. 너 바빠? 안바쁘면 오랜만에 만났으니까 얘기 좀 하자.	4
고양이 괜찮아 그런데?	1
네. 그래야겠어요. 고마워요 쌤.	7
저 지금... 어깨가 얼얼하거든요? 이거 보상 어떻게 하실거에요?	3
오~ 로맨틱해. 그래서, 고백은 했어?	7
엄마가 단 거 먹으면 안 된다고 그랬는데. 엄마 화나면 진짜 무서운데.	2
정말? 에이구… 어릴 때부터 그러더니. 다 커서도 그러는구나.	3
아주 간이 큰 놈이야, 이거.	0
아 됐다니까. 내가 염치없어서 그래요.	6
자녀분들한테 공기청정기라도 하나 사달라고 하셔요. 요즘 미세먼지가 노인 분들한테 더 안 좋대요.	6
엄마 나 진짜 엄마한테 꼭 부탁할거게있어	4
내가 뭐라고 말려? 가서 니꿈을 펼쳐!	7
으, 생각도 하기 싫어.	3
길에 CCTV설치하는게… 하고 싶다고 할 수 있는 게 아니라…	2
벌써? 내년이면 이제 3학년이네.	5
사실 그 분이, 사장님 동생이래.	1
알았어. 이게 지인 소개가 좋다니까.	7
그래. 천천히 오라 그래. 회사 일 바쁜데.	7
아.. 그 녀석이 그럴 사람은 아닌데.	2
왜. 싸웠어?	1
 아니면. 그만 참견하세요. 음~ 진짜 뭐야~	6
그 이후로 다들 걔를 피하기 시작했어.	4
당신이 뭘 자세히 봤어야 말이지. 장판 끝도 일정하지 않게 잘려있다니까?	3
나는 지금 신발 완전 신고 있어서 냄새 안 나. 너 약간 발 빼고 있어서 냄새나는 듯.	3
또, 기억나는 꿈 있어?	2
뭐 큰 병이 있었던 건 아니죠?	4
안마 좀 해봐.	7
이모, 나 화장 하는 법 알려 주면 안 돼?	4
멋있다. 그럼 너도 고등학교 가면, 알바할거야?	7
안녕하세요 작가님.	7
나 어제 딱 급식 먹고 와서 보니까 그 펜 없어졌는데, 마침 네가 가지고 있네?	6
가는 말이 고와야 오는 말이 곱죠. 삼촌을 좀 되돌아보세요.	0
병원에서 뭐래? 다리는 괜찮대?	2
아 됐어!!! 오늘 학주 떠서 얼차려하면 다 엄마 때문이야!!!	3
좋아 죽는다고 붙어다닐 땐 언제고, 갑자기 왜 맘이 식어.	4
 그래. 그럼 언제 사러가지?	7
너가 낼 거야?	3
"아무리 바빠도, 해야 할 일은 해야지.	  저기요."	6
머리가 좋긴 뭐가 좋아! 누나도 공부 못 하잖아.	0
수술은 잘 끝났는데…	7
학원은 무슨 학원이야.	6
노래는 좀 하나?	5
아 그럼 어떡하라고요. 저 죽기 싫단 말이에요.	2
논술? 벌써 그런걸 배워?	2
그동안 김미주씨 정말 수고 많았어. 덕분에 고마웠어. 일이 한참이나 수월해졌어.	1
우리 집에 오면 훈장이 몇 갠데 그걸 몰랐냐?	0
어머, 벌써 시간이 그렇게 됐어?	5
아이씨… 죽을래?	0
말을 더럽게 하니까.	3
사채썼어?	5
왜? 얼마나?	5
아빠는 맨날 아빠만 힘들지! 학생도 얼마나 할 일이 많은데!	0
좋겠다고? 여자들은 그게 좋아?	3
그럼, 당연하지. 나도 운동 좀 다시 시작할까봐.	1
어휴, 자리에 앉아 있으면 숨도 못 쉬겠어요. 저도 아직 특별히 바쁘지는 않은데, 제가 낯설게 느껴서 그런 걸지도 모르겠지만... 분위기가 너무 삭막한 것 같아요.	6
선생님이 도와줄 수 있어. 어머니도 보호 받을 수 있는 기관이 있고. 여러가지 방법이 있어.	4
 실례할게요.	1
와 좋겠다. 어떤 친구야?	5
아니 아무리 그래도 애들도 있는데.	6
허이구, 무섭네 무서워. 누가보면 독립투사인 줄 알겠네.	3
나도 다 컸는데 이제.. 편식쟁이가 뭐야?	6
죄송합니다. 그럼 다른 메뉴로 주문하시겠어요?	2
이 먼지털이로 책상 먼지부터 좀 털어내.	7
오. 괜찮네요.	5
어휴. 근데 등록금은 진짜 안돼. 나중에 세빈이 결혼한다고 하면 조금 도와주던가. 애가 돈 버는 게 어려울 줄을 알아야지. 너 믿고 알바도 안 하는 것 같아. 지 친구들 다 알바해서 용돈 버는데.	6
응...	2
뭐 두 시간 정도밖에 안 남았는데? 그동안 엄마랑 만화 볼까?	7
또 차였다면서.	4
할머니 요즘 외국에서도 인기를 끌고 있는 ABCD라는 그룹 알지?	7
감사합니다 선생님. 감사합니다.	7
해인이가 착해? 해인이 어떤 면이 그렇게 착한데?	3
응. 남자야. 그런 사람들 보면 꼭 남자더라고.	3
젊은 애가 살맛이 안 나긴 뭐가 안나?	3
고모도 [누몬] 해봐야 돼!	3
안녕하세요.	2
근데… 형은 이제 어른인데 왜 세뱃돈을 받아? 애들만 주는 거 아니야?	1
나 여친이랑 헤어질까봐.	4
다이어트? 다~이~어~트???	3
야, 강인아. 이 아빠는 백수가 아니라, 프리랜서야, 프리랜서.	3
그것도 좋아.	1
그럼 어떻게 해?	5
거제도? 거제도면 남해 아니냐?	2
머리 이렇게 잘랐다고 엄청 뭐라 했어.	4
완전 쓰레기던데!	3
 아 여기있네요 고객님. 고객님은 그 때 사은품 대신에 할인 받으신 케이스세요! 사은품은 따로 안 나가세요.	1
할머니가 몰라서 그래~	6
 그래도 예뻐요 누나. 누나가 제일 예뻐요.	7
"너는 추석인데, 어디 안 가?	  왜 여기서 이러고 있어."	6
아. 사실은 제가…. 그러니까 제가, 아이가 갑자기 아파서 오늘 일찍 가봐야 하거든요.	4
니가 전공이 뭐였지?	7
"아 평화롭고 좋아. 이 나이가 되도록 	너무 여러가지 일들이 있어서 지금이 	여유롭고 평화롭고 좋아."	4
내가 생일 더 빠른 데 제수씨지. 형수는 곧 만들어 줄게.	0
응. 이모 잠꼬대도 해.	1
나는 밀리면, 그 학습지 중간, 중간마다 딱풀로 붙여서 한장으로 만들어버려.	1
아… 제가 여기서 며칠 전에 핸드폰을 하나 샀는데요..	4
아저씨가 헐렁이에요?	5
할머니는 네가 거짓말 하면 다 알 수 있어. 알았어? 거짓말 하는 거 아주 나쁜 짓이야. 할머니한테 똑똑히 말해 얼른.	3
엄마 근데 나 배고파.	1
어머? 내일까지 안 된다고? 경비실에서 그래?	0
네. 저도 젊을 때 이 친구 도움 많이 받았어요. 살 빼는 것도 중요하지만 무엇보다 건강을 유지해야 하니까요.  참, 김 과장님, 오늘 점심 메뉴는 제육볶음이었어요!	7
식단이 나쁘지 않은데요?	1
병원 가야지. 엄마한테 문자 했어?	5
그건 모르는거지. 너 조심해.	7
제 말 안 들리세요? 그걸 왜 물으시냐고요.	0
너? 아니 엄청 괜찮은 여자라니까. 대기업 다니고 있고 아버지는 교수, 어머니는 초등학교 선생님. 이혼녀라 좀 그렇긴 한데… 집안에 재산도 있고 선생님 집안이니까 예의도 바르고 착하대.	1
야 너 지금 장난하냐? 진지하게 들어 임마. 진지하게.	0
너 명자한테 식초 먹였다며?	0
야!!! 냉장고에 있던 아이스크림 니가 다 먹었지!!!!	0
흠… 진짜 외제차 확 뽑아버릴까요? 집이고 뭐고.	6
억울하실만 하죠. 형이 형수님한테 얼마나 잘 했는데.	6
저 지금 엄마 부를거니까 여기서 딱 기다리세요.	0
한 시? 한 시까지 술 마신거야?	3
응. 아버지 없다고 놀림 받고 손가락질 받는데, 삐뚤어지고 엇나가면 더 어머니가 속상할 것 같아서 공부를 더 열심히 했지.	4
기운 내. 내가 아는 세형이는 이 정도로 기죽을 애가 아니잖아! 우리 아이스크림 먹으러 가자.	4
공대?	5
면허… 있었지! 있었어!	5
네. 오늘 저희는 두근두근! 푸드 파이트를 하기로 했습니다.	7
하은아. 언니가 엄마랑 얘기했어.	4
 집이 괜찮네요. 보증금이랑 월세가 얼마라고 하셨죠?	2
아 정말?  어머니랑 같은 기수 되겠네.	5
에이. 나는 그런거 못 봤어. 난 그냥 김치랑 해서 먹었지.	4
너무 적으시죠? 죄송합니다. 저희가 이게, 제 개인 돈으로 찍는거라.          돈이 너무 부족하네요.	4
걔가 내 옷 입어놓고, 계속 아니라고 우기잖아!	0
엄마, 나 학교 그만 갈래.	6
너 주문 안됐지?	3
결혼은 했냐 안했냐 이딴 거 묻더라.	6
형은 나이가 많으니까 그래도 되지만, 너는 안 되지!	4
아무도 얘기 안 해줬는데. 우리 할머니한테 동생 있다는 얘기.	5
제가 반장이잖아요. 그래서 애들 대표로 물어봐야 할 거 같아서요.	2
싫어요! 수련회라면 질색이에요!	3
너도 이제 사람들이 물어보면, 언니요~ 그렇게 대답해.	1
이걸 읽고 메신저앱을 지웠다는 거야?	3
"병훈이 그 자식은, 나한테 뭐 말을 안해.	 애들은 걔가 엄청 수다쟁이라는데,	 내 앞에선 벙어리야 벙어리."	6
 잘 먹겠습니다… 다녀오세요. 사장님…	7
너도 멋있어.	7
"어우, 그 집안 남편도 사사껀껀 규칙 들먹이면서 사람들 귀찮게 하고 다니더만	 아들내미도 똑~같이 그러고 있네."	6
그러니까요.	4
알겠어 든든하네 우리 아들	7
그게 뭐 내 맘대로 되나.	6
그러니까. 나도 좀 시간을 두고 가지고 싶긴 했었는데… 이렇게 되어버렸어.	6
우와…할아버지도, 모르는 게 있어요?	5
너 옷이 그게 뭐야?	5
에헤이, 무슨 소리야. 그냥 가만히 기다려.	7
뭐야. 너 여자친구 있어?	5
탓 하는게 아니면 뭔데? 지금 내 탓 하는 거 아니야?	3
음. 어머니는 돌아가셨고, 아버지는 재혼을 하셨습니다.        오빠 한 명이 있는데, 고등학생이라서 얘기는 잘 못 해요.	4
얼른 니 엄마 따라 갈란다.	4
" 무슨 소리야.  	 잉크 안 날아가게 앞에 캡 다 붙여 나오는데."	0
내가 그걸 알았어?! 그렇게 잘 아면 니가 하지 그랬냐!	3
어! 우리는 그래서 방역 따로 안하고, 직접 약 쳐.	1
언니도 요즘 학교 생활 힘들어? 언니 공부도 못 하잖아.	1
제가 지금 너무 하는거라구요?	0
달달한 술인데, 도수가 꽤 높아.	1
불법 같은 소리하네. 우리는 재료를 사서 쓰는 게 아니고, 죄다 농사 지어서 쓰는데, 손님이 남기는 족족 버리면, 그거 아까워서 어떻게 하냐?	3
" 에이. 이건 엄마 취향 아니다.	 엄마는 역시 달달한 바닐라 라떼가 좋아."	6
나만 모쏠이야.	4
네.. 저도 이제 그런 고민을 좀 할 때가 된 것 같아요.	2
학생 같은 게 뭔지 몰라?	0
그러면 누가…?	2
지금… 바퀴 벌레 좀 대신 잡아 달라고… 여대생을 불러내신 거에요?	3
아 준성이랑.	2
미치겠네 진짜…	0
사고쳤냐?	5
엄마는 그 형 안보고싶어?	4
할아버지, 이따 마감하러 가야 돼!	6
너 요즘 만나는 사람은 없어?	2
아…	2
이번엔 얼마나 올랐대?	2
선생님이 어머님 뵐 면목이 없다.  그러길래 중간고사 일주일 남기고  첫사랑 얘기 해달랄 때부터 내가 알아봤어.	0
아 네. 저 올해 19년에 졸업 했습니다.	1
아깝게 뭘 그렇게 해. 됐어. 그냥 먹어.	3
예.. 교수님 힘드셨던 거.. 누구보다 제가 제일 잘 알아요.	4
버스 없어요.	0
배수로 공사만 하면 되는거 아니여.	6
저희 아빠… 아니 그 자식은… 인간도 아니에요.	3
그냥 하지 마.	3
내가 지금 좀 그래. 진짜 좋은 사람이고. 생활하는 패턴도 잘 맞는데,        뭐랄까. 생활이 너무 노부부같아. 그냥 저냥 평범하게 잘 살 수 있을 것 같아서       결혼 생각하면 좋을 것 같긴 한데. 가정적일 것 같고.	4
모르면 어쩔 건데!	7
아 진짜 미치겠네. 진짜로 아니라니까요?	0
뭐… 문제는 아니지만… 선배는 제 스타일 아니라서...	1
어..없어!	3
 저 돈스테이크 닮았어요?	3
형… 그럼 친구가 없어서 책만 본 거야? 우리반에도 그런애 있는데… 박지윤…	4
지영씨 진짜 축하해!	7
응, 퇴근하자마자 바로 시장 들렀다 올게. 일곱 시면 집에 도착할거야.	7
아니, 그런 건 아니고. 연극 초대권이 한 장 생겨서 너랑 같이 볼까 했지.	1
술은 한번 나올 때 한 병씩 밖에 안돼요.	6
"랍스터? 	 그건 지금 구할 수가 없는데."	6
추억 돋네.	1
그럼 주변에 있는 어른들한테 여쭤보면 되죠. 잘 할 수 있을거예요.	5
네 기침이 어떻게 심해지셨죠?	1
그렇지. 언제쯤 일 좀 그만하려나. 아아.	6
새벽 4시 쯤에 지나갔어요. 저는 인도로 걸어가고 있었는데 하얀색 자동차가 초록색 자동차를 박더라구요.	5
알았어 미안해 이제 니네집 앞에서 만나.	4
그런 게 어디있어! 친구는 친구지.	0
너네집 투룸인데 뭐가 좁아.        그냥 거실에서 우리 둘이 자고 아빠는 방에서 자면 되잖아.	0
너 서울 가기 전에 방 정리 좀 하고 가. 버릴 것 좀 버리고.	1
응. 완전 상전벽해야.	4
 아… 호박죽….	6
응. 나는 이 분야에서 짱 먹는게 목표야.	7
헐…. 그 여자가 얼마나 기가 쎈거야?        그 정도면 거의 자기도 무당인 거 아니야?	2
하... 나도 말이 안 통해서 죽겠다 진짜…	3
어휴!!	0
어느새 이렇게 다 컸냐, 우리 딸.	7
야.. 너네 형이 이성빈이야?	2
당연하지. 우리 딸이 제일 소중하지. 남들한테 쪽팔린 게 어디있어.	5
돼지고기 메뉴 중에선 뭐가 제일 맛있나요?	1
 진짜로 괴롭힌 적 없다니까?	0
 아 이거 말이야?	5
네…? 화가 많이 나셨네요. 조금만 참아주시고… 조금만 기다려주시면 좋은 퀄리티로 제가 보답하겠습니다 진짜..	2
앞으론 이런 일 없도록 하겠습니다.	4
그게 티가 나?	5
그럼 전에 사부인께서 좋아하시던 국화차 있는데, 그거 한 잔 드릴게요.	4
아니야 주인공이 그렇게 갑자기 정신차릴리가 없어	6
네. 수경이는 이제 이 세상에 없어요.        이제 아무도 가질 수 없어요.        영원히 제꺼에요.	2
몰라 얼마 안 됐어.	2
난 누구 편도 아니야.	1
헐 뭐야	1
아 네. 제가 작가라… 주로 집에서 생활하거든요.	1
 네…	4
아 어렵든 말든!	0
"아니야. 아직 30분도 안 됐어. 	가서 치워야겠다."	6
무서우면, 너가 돌로 뱀을 찧어 죽일게 아니라, 어른을 불렀어야지. 왜 멋대로 구는거야? 응?	0
천천히 줘도 돼.  근데, 너는 왜 전학 왔어?	7
아이, 그럼 뭐 어쩔 수 있어? 당연히 그 쪽으로 가 봐야지.	1
카드 안되는데… 학생만 해주면 앞으로 우리는 어떡해~	2
"나 없을 때 우리 집에 왔었어요? 	뭐 하러요?"	3
신상 음료수 좀 갖다 놓으라고 했더니.. 학교가 어디냐는 둥, 부모님이 어딨냐는둥… 어리다고 너무 무시하시는거 아니에요?	3
 네…	4
        ……….잘 처리를 해뒀습니다.	2
꼬마야. 사탕 먹을래? 	7
아니고. 이게 새로 나온 맛이야.	7
니가 왜 죽어. 어? 걱정 마. 엄마가 다 알아서 할게. 알았지?	0
…..그래서. 어떻게 됐나요?	4
안돼. 소속사에서 난리칠걸?	6
흠... 엄마한테 한번 물어볼게.	1
어쨌든, 동훈이한테는 성적 가지고 너무 닦달하지 마세요. 괜히 스트레스 줘서 좋을 거 없어요.	7
고소 당하면 어떡해.	2
한 쪽 붙이는데 한 3분...?	1
아니 남녀 분반인데 어떻게 만났대?	5
내가 뭐가 비겁해?!	3
 그래 어? 이거야? 어머. 예쁘다. 얘세상에. 요즘은 이렇게 나오는구나. 얘가 신랑이야?	7
"아이고. 어린 놈이 그래도 기특하네. 걔도 상처 많이 받았을 텐데 	 둘이서 잘 보듬고 살아."	4
여자친구는. 뭐 대학은 어디 나왔어?	1
오빠는 지금 취직했다고 유세떠냐?	6
네.. 그럼 잘라주세요	6
바꿔줘야지. 학생이 이렇게 힘들어하면 교사로서 당연히 노력을 해야지.	4
화장실 같이 가주시면 안돼요...?	2
그러니까 말이야.. 시간이 진짜 빨라! 나도 이제 이러다가 금방 은퇴하겠지 생각하면 기분이 요상해 요즘	4
네 자퇴하고 검정고시 봤습니다. 지금 수능 공부 하고 있습니다.	2
아무 사이트나 맘대로 들어가면 어떡하냐고!! 바이러스 걸렸는데!! 내 데이터 날아가면 어떻게 책임질건데? 어?	0
그럼 됐죠?	3
네, 감사합니다 선생님..	1
저, 논술반에 들어가려고 하는데요.	2
세원아… 정말 미안해. 나도 내가 로또에 당첨될 줄은 꿈에도 몰랐어. 그리고, 이렇게 빚을 갚게 될 기회가 오리란 것도 몰랐어. 그렇지만 나에게도 너무 절박해.	4
엄마. 요즘은 각자 자기가 잘 하는걸 더 파고드는 시대인거 몰라? 옛날처럼 공부만 한다고 성공 하는게 아니라고.	0
니가 갖기 싫다고 그랬어.	2
누구지?	5
내가 왜 얹혀사는 거니. 난 같이 사는 거고. 니가 얹혀사는 거지.	3
마음 같아선 그러고 싶다! 왜 헤어지려는건데?	0
왜 또 예민하게 굴고 그래. 요즘 애들은 우리 때랑은 다르다니까.	6
좋아하는 사람? 있지. 예쁜 걸그룹 언니들.	7
아 됐어. 알지도 못 하면서. 나도 돈 쓸 데 많단 말이야.	0
어. 덕진이가 할아버지 소원 들어 줄래?	1
아.. 하기는 그렇죠. 학비도 학비지만, 취업을 바로 못하면 기회비용이 있으니…	4
"이런 게 사랑이야? 	연서 때랑은 또 다른 것 같아."	6
아파서 못 견디겠어.	6
잘 아네. 내가 두번이나 기회를 줬잖아.	3
아 언니 극혐. 개기긴 뭘 개겨	3
왜 확인을 못했지. 나중에 읽어 볼게요. 댁이 양평이시네요.	5
벌써 시간이 그렇게 됐나? 하긴, 난 진희 유치원때밖에 생각 안 나는데, 지금 몇 살이지?	5
니가 엄마아빠한테 잘해야 돼.	0
싸우긴~ 우리 안 싸워.	5
 왜.	1
안 핀다니까 얘기하는거야.  내가 분명히 얘기 했다 폐 썩는다고!	0
밤 늦게까지 일하고 왔으면서 집에서는 좀 쉬지.	4
에이 뭐야, 할머니 치사해.	6
어휴 진짜 이모는 언제 철드냐.	3
헐.	4
에이, 삼촌 답지 않게. 왜 그렇게 철학적인 소리를 하고 있어?	3
형이야 민정이 명문대 보내놨으니까 속 편하게 말하는거지. 세빈이는 민정이랑 또 달라요. 민정이처럼 알아서 척척하면 걱정도 안하지.	6
"그러던가요 그러면. 	젊은놈이 벌써부터 꼰대가 돼서 어쩐다냐."	3
비슷한 거지.	5
저런. 본인은 얼마나 힘들꼬.	4
당연하지. 그 돈 빼먹으려면 20년은 더 해야 된다. 20년은.	0
왜 그랬어. 지은이 때리면 안 된다고 했어 안 했어?	0
그럼 나가서 알바라도 해야될 거 아니야. 하루 이틀도 아니고 몇 년째니 지금.	0
"그지. 근데 요즘은 그게 되나. 	 빨간 날에도 다들 바쁘게 살지."	4
하… 그러게 왜 이렇게 깊은 데로 이사를 왔어…	4
 아 그래요? 자제 할게요. 미안해요. 나도 일하고 우리 애들 아빠도 일을 하다 보니까 집안일을 할 시간이 없어서 가끔씩 그렇게 됐네요.	3
나도 알 건 알거든?	0
"아휴 정말. 옷에서 구수한 냄새 나고 좋지 뭐!	 니 방에 퀘퀘한 냄새 나는 것보다 훨씬 낫겠다!"	0
아무 것도 손에 안 잡히고 손주 생각밖에 안 나더라구요.	5
오빠가… 괜찮지 않잔아.	3
 죄송합니다..	4
 아 진짜 짜증나게 진짜. 가뜩이나 오늘 일진도 안 좋은데.	0
이 근처? 어디까지가 이 근처인데? 지하철 닿으면 다 이 근처인가?	5
아 정말?	7
지금 나랑 싸우자는 거야, 뭐야?	0
할머니, 평소에 꿈 같은 거 자주 꿔?	1
"진짜요?	 아빠는 해봤다고 했는데?"	5
뭘 또 그냥저냥해. 너 정도면 잘하는거지.	7
만화책이야?	2
"재미있는 영화는 아니지. 	가슴이 먹먹해지는 영화지."	4
하하하...	5
너무 존경해. 앞으로는 진짜 극진히 모실거야.	7
"응. 첫회차 때 긴장이 덜 풀려서, 목에 힘이 들어가서 갈라지는 거랑은 다르게,	 오늘은 좀.. 목이 지친 느낌?	 확실히 무리하고 있는 느낌이 들었어."	2
또?	5
너가 방구쟁이지!	0
내일도? 너 어제도 연습했잖아.	6
"아니야. 너는 너 하고 싶은 대로 해. 	너한테는 면을 먼저 삶는지, 달걀을 먼저 삶는지 그런 거 별로 안 중요하잖아. 괜찮아."	2
원래 인생이 이렇게 힘든 건가요?	6
뭔데. 편하게 말해. 선생님이 들어줄게.	7
응. 근데 UFO가 진짜로 있다면,        그런 세상이 왠지 진짜로 있을 것 같거든.        우리는 모르지만, 우리보다 훨씬 발전한 외계인들은        그런 세상도 마음대로 다닐 수 있을 거 아니야.	4
저번에 자네가 찍은 당 때문에 나라 말아 먹을 뻔한거 몰라?	0
난 언니가 걱정돼.	3
아빠 수술했어? 무슨 수술했는데? 아빠 어디 아팠어?	5
제발, 형...	4
그래 잘 생각해봐라.	4
네. 남자친구는 둘 다 취업만 잘 되면,        결혼할 마음도 있는 것 같더라고요.	7
어 스트레스 받는다. 받아.	0
몰라.. 연휴만 되면 이상하게 업무 관련해서 문자를 보내는데… 아주 편지를 써 편지를… 읽기도 싫어.	3
 [지금 당장 당신의 SNS 계정을 삭제해야 할 10가지 이유]?	5
다른 사람 말을 잘 듣는 사람이면 애초에 대학원 올 생각도 안 했겠지.	3
모르겠어요. 저한테서 냄새 나나요?	2
단 거는 지금 별로 안 땅기는데…	6
친구들 다 노트북 있단 말이에요.	6
여기, 아메리카노에 샷이 몇 개 들어가요?	6
에이. 치사하게 그 까짓 꺼 뭐라고. 언니가 돼선.	0
네, 그럼 다음에 다시 뵙겠습니다.	7
완전 애기네.	7
니가 살이 쪄서 그래. 게을러 보이잖아.	3
그래, 그 아주머니. 그 아주머니가 오늘 너보고 내 남자친구냐고 하더라.	6
너 알바하는데 엄청 궁금해. 가보자.	1
저야 좋지요. 요즘 외로웠는데.	7
음... 그럼 어떡하지. 엄마 옷 하나 새로 사면 안돼?	5
화장실 칸 안은.. 사방에 벽이 있어서 도망칠 데가 없으니까요. 저한테 마우스 피스까지 끼우고 팬 놈이에요.	2
아무래도 사근사근하고… 그래서… 영업에 좀 도움이 되는 편이지 않을까 그런 생각을 했습니다…	2
우리 원래 인터넷 안되는 그냥 피처폰을 2G 폰이라고 했었잖아~ 기억나?	2
너 요즘 시험 기간이야? 그럼 언제쯤 해줄수 있는데?	5
한지훈. 너 이리 와봐 엄마한테	0
지상준은 아무나 다 때려요. 걔는 진짜 무서운 애에요. 학교가 동물의 왕국이면 갠 포식자에요.	2
행님은 언제 헤어지십니까?	1
부모님 때문에? 무슨 일 있어?	2
네 맞아요, 어떻게 아셨어요?	5
대충해도 돼. 불알 친구들인데 뭐 어때.	3
응. 가고 싶은데 경쟁률이 치열하다고 해서 너한테 부탁할까 했지.	7
네? 왜 자꾸 그러세요.. 꼭 나오지 말라는 소리로 들리네요.	2
음... 삼계탕 어때?	7
오빠가 나 찔렀잖아!	0
비용 절감이랑도 관련이 있나요?	1
안되겠다.  니가 깨줘.	4
할머니, 마트에 안 가세요?	1
공부 잘 하는 수진이는 다이어트 한다고 밥도 안 먹는데 전교 3등하더라.	0
 미정이 너 일로 와봐.	0
아 그럼요!	1
오랜만에 전 직원이 친목 다지러 가는 건데,  설마 숙소가 엉망이어서 기분 다운되는 일은 없겠지?	6
뭐?	3
죽…진 않았어. 잘 봐!	1
나는 운동을 통해서 체력을 기르는 것도 좋지만, 싸움도 잘 하고 싶어.	2
그럼요…?	2
속발음하면서 읽는 거 아니야?	1
그래?	5
응! 근데 이모가 문도 안 열어줬어!	6
아 맞다. 수영복 새로 사야 되는데 엄마한테 말해야 되는데 까먹었어.	5
네. 애들이 얼마나 무서운데요.        아무튼, 저 입을 옷도 없고,        애들끼리 눈치 보는거 못 하겠어요.	6
혁수 재수할 때도 같은 방 쓰는 것 보다는 낫잖아.	1
이게 뭐야?	1
네… 저희 집은 외식을 잘 안해서.	1
아니 그냥 뭐.. 내가 다치고 싶어서 다쳤나…	6
응 그래. 준영이도 조심히 서울 올라가고.	7
네… 제가 말씀드린게 그건데... 그게 진짜 제가 딱 원하는 거거든요…	2
아 하나밖에 안 먹었다니까? 그것도 퍽퍽살로 먹었다.	3
 그냥 타지 살이 외롭고 힘들었다고 해.	1
그거 뭐 싼 거는 10만원부터 비싼 거는 100만원씩 하죠.	6
 어머. 어머....	4
 거기 해미 엄청 예쁘지?	7
야 일러라 일러!	0
아 감사합니다. 감사합니다,	7
안 돼.	0
"어. 마트 같은 데서도 다 배달해줘서, 먹는 건 걱정 안 해도 돼. 	 회사 다닐 때보다 더 잘 먹어."	7
네. 옷은 안 입었어요. 아, 그리고 요즘에 미용을 해서 엄청 귀여워요.	5
저기 사장님.	2
�� �� ���� �ʹٸ�? �������� ���� ��å ������ ���� ���̾�Ʈ�� �ݹ��ϰ�?	1
그거밖에 안된다고? 소값이?	0
보기엔 괜찮은데?	1
뭘 어떡하긴 어떡해. 알아서 살아야지.	5
그러니까 말이야. 갑자기 그렇게 됐대.	4
그게 맞는 말이긴 한데, 걔가 금전적으로 너한테 너무 많이 의존하는 것 같아서 걱정이야. 이제 노트북을 끝으로 대학 때는 돈 주지마. 맘 같아서는 노트북도 주지 말라고 하고 싶은데 이미 니가 얘기를 했으니까.	6
그게 누구야?	1
시영이가 나랑 얘기한 건 어떻게 알았어?	7
그래야지. 자식 놈들도 아주 그냥 농사 짓지 말라고 난리야.	6
안 그래요. 제가 바보도 아니고.	6
제가 지도를 잘 했어야 했는데… 정말 죄송합니다…	2
그래… 나중에 무슨 일 생기면 누나한테 제일 먼저 얘기 할게…	1
생각해보니까 빵이라도 좀 사갈 거 그랬어.	1
아~ 원래 간을 슴슴하게 드시는 걸 좋아하세요?	7
선배들이 대학원 오지 말라고 할 때 새겨 들었어야 됐는데.	1
신입사원들 등산 동아리 자동 가입, 한 달에 한 번 등산 행사 필참인 거, 경력직으로 들어온 조 과장도 알지? 근데 재호 씨가 거기에 반기를 들고 나서더라구. 우리 본부장님까지 계신 자리에서 말이야.	6
자기, 전생에 왕족이었어.	7
무슨 아지트같네.  교환일기 두기에 딱이다, 그지. 그럼 선생님이 먼저 써서 여기에 갖다 둘게.	7
그냥 그렇지 뭘. 그만 신경써 아빠.	4
아니 그런 건 아닌데.	2
아버님과 함께 운영하시던 가게를, 어머님이 이어서 하고 계신 거에요?	4
또 놀리는 거야! 나 그런 징크스 없다니까.	0
누난 뭐 먹고 싶어?	1
왜? 그게 싫어?	5
"뭐? 뒷담화 철벽을 치시겠다~	 연정이 역시 똑부러진다?"	6
아이고. 아버님 맞습니다 맞아요. 원 플러스 원이에요. 뿐만 아니라 한 번에 열 박스 구매시에는, 사은품으로 선풍기를 드리고 있어요.	7
유치원에서 내가 주영이한테 화가 되고 싶다고 그랬거든? 그랬더니 주영이가 화가는 가난뱅이 된다고 놀렸어.	4
"반장을 그만 둬? 그게 무슨 말이야. 	원래 반장 한 번 하면 한학기는 그만두는 거 없이 쭉 하는 거야."	5
근데 아주머니, 덥지 않으세요?	6
 그래? 그럼 나도 내 할 일 할게.	7
모래요..? 전 모르겠는데.	2
알았어.	7
아 미안. 바람 소리 들으니까 마음이 엄청 편안하다.        눈 감고 있으면, 바닷가에 온 것 같기도 하고.        왜, 파도가 밀려오는 소리 있잖아.	7
어머니가 이 시간에 어쩐 일이세요?	3
뭘 몰라?	2
일은 잠깐 육아휴직 쓰려고. 애기 어린이집 다니면 다시 일 나가면 되니까.	4
실은… 오늘 좀 충격적인 걸 알게 됐어.	2
비싼 줄 몰랐으면 쓰지 말던가. 이래서 남의 물건, 함부로 쓰면 안되는거야.	3
어쩐지 애들이 빤빤하니 이쁘더라. 씻기기도 해?	1
왜 복성이 그 녀석도 폐가 안 좋다는데 계속 피우다가 결국 폐암 걸린 거 아니냐.	0
걔 절!대! 내친구 아니거든? 그러니까 언니두 나한테 얘기할 때 조심해 줘.	0
나는 몰랐지… 그런 걸줄은…	4
너 이제 가면 언제 오냐? 그동안 보고 싶으면 화상채팅하려고 내가 산거야.	7
그랬다더라.	2
"그 놈은 지 데려갈 짝이나 찾을 수 있을라나 모르겠어. 	 맨날 일 아니면 게임, 아니면 바이큰가 뭔가 오토바이타고 싸돌아 댕기기 바빠."	4
그지. 보통은 메신저로 하거나 메일로 남겨놓지.	2
아 저는 커피 안 마셔서 탕비실 이용 별로 안 할 것 같아서요.	1
"그러네. 쨌든 그런 것들이 너희 남매의 특징이야.	 한 마디로 에너지 과다."	3
그래서 막 뭐라고 했어?	1
 아 왜 때려.	0
나 설거지 했는데?	5
칫솔. 치약. 락스. 샴푸?	5
"네...!   선생님 생일선물 주셔서 감사합니다.	 이제까지 받았던 것 중에 제일 좋은 거 같아요."	7
알지. 그래서 봉투만 보내려고 했는데 다들 간다고 하니까	6
그렇구나. 엄마도 참 대책없다.	2
정말? 나 진짜 몰랐네. 왜 몰랐지?	5
네. 근데 저는 말고 선생님이랑 지우랑만 얘기하면 안돼요?	2
나 뭐. 보통은 되지. 너 못 먹냐?	7
아….	3
네?	2
아, 다행이네요.	2
나? 언제 갔더라. 지난 설에 안 갔으니까… 할머니 생신?	5
부정적인게 아니라 그만큼 어렵다는거지! 후투부 하는 사람들이 얼마나 많은데.	1
네, 학교에서 배가 너무 아프다고 해서 조퇴했다나 봐요. 병원에 데려가야 하는데, 지금 데려가 줄만한 사람이 저밖에 없거든요. 제가 가야할 판이예요.	4
옴마야! 임신이요? 우리 남편 묶었는데 그게 어떻게 가능해요?	3
네 그냥 쭉 가면 나와요.	7
그게 무슨 말이야?	2
있다가는 없다니까. 엘리베이터 잡아 놓을 테니, 지금 나와요.	0
타령이 아니고 진짜야!	0
아...! 그때 니가 하도 시끄럽게 떼를 써서 그런거잖아! 오히려 혼나야 되는데!	6
왜?	5
주판이 뭔데?	5
나중에 더 큰 집 사드릴게요. 엄마.	7
네... 알고 있어요. 부탁 드리겠습니다.	2
둘만 간 거 아니야. 걔네 엄마도 같이 갔어.	1
난 진짜 장난 아니고 꼭 부자될거야.	1
선생님이 널 왜 불렀는 지 알겠니?	4
응 차도는 좋대 아직 좀 더 두고 봐야 겠지만	4
일단 편집 프로그램을 켜고	1
제가 인터넷에 리뷰 올리면, 이깟 가게 망하게 하는 것쯤은 일도 아니에요.	3
왜?	5
아이고 어떡하나. 아들 비행기가 3시인데, 그 전에 갈 수 있을까….	6
"뭔 소리야. 갑자기. 	 근데 아빠 진짜 못생겼다고 차였어?"	5
그래? 빨래통에 넣어 놓은거 아니야?	5
이모, 나 아이스크림 먹고 싶어!	4
돼지. 왠지 알아? 내가 내 돈으로! 지원하는 사업이거든.	0
아! 감사합니다.	7
입이 마르게 칭찬하셔서, 한번 꼭 이야기 나눠 보고 싶었어요.	5
그래서 그냥 니가 뽑았어? 어떻게 뽑았어?	3
너 남자애가 왜 그렇게 용기가 없어?!	3
자꾸 거절하는게… 설마 진짜 나랑 밥 먹기 불편해서 그러는거 아니지?	7
"민준이 엄마는, 이제 엄마야.	 서준이도 다른 엄마가 낳아주셨지만, 엄마 아들이 됐잖아."	6
아 그럼 영어 선생님 드려야 되겠다.	7
저도 빨리 면허도 따고 운전도 해보고 싶어요..!	1
그 다음에 컴퓨터로 해야 된다는 겁니까?	2
어머, 그게 아르바이트에요? 자원봉사인줄로만 알았는데.	5
누나가 부탁해서 그렇지. 나도 친구 만나고 싶어.        누가 너랑 있고 싶댔냐.	6
 오늘은 뭐 하셨어요?	7
나는 다음 생에 태어나면 꼭 미술을 해보고 싶어.	4
이게. 맞을래 진짜. 좋은 말로 할 때 나가라.	0
엄마가 그 꼴을 봐야 돼. 아…   나 진짜 이것 때문에 현주랑 이혼하고 싶어.	3
햄버거.	6
아니… 사장님.. 여기 백반집인데… 김치찌개 된장찌개 순두부찌개… 다 안된다고 하면 저더러 뭘 먹으라는거예요…	0
버섯은 포자 번식을 한대…	1
지철아… 엄마 왔다…	1
" 갑자기 왜 그래.	 학교에서 누가 괴롭혀?"	6
 저보다는 재희를 더 닮아야 할 텐데 말이예요. 이 호의는 절대 잊지 않겠습니다, 조 과장님.	7
야... 너 희정이랑 잘 안 됐다며...	1
또 또 기억안나는 척 한다. 그것도 너 고질병이야. 인정할건 인정하고 사과를 해서 사람 마음을 풀어줄 생각을 해야지.	3
보냈어 언니.	7
그렇지? 아무래도 오늘은 날씨가 너무 더워서 안 되겠다. 요 앞이라도 잠깐 나갔다 와야겠어.	1
네…	2
 오히려 지금 블루가 튀는 컬러고, 그린이 차분한데.	3
응. 적금 붓는다고 생각하고 들어야지.	1
그래, 그럼 복숭아는 빼는 게 좋겠다. 전무님이 알레르기가 있는 지 없는 지도 모르는데. 와이프는 어떨지 또 어떻게 알겠어.	2
지금은 하나도 못 받은거야?	2
너 내가 내 방에 함부로 들어가지 말랬지!	0
어제? 어제 어쨌더라… 해 뜨지 않았나?	5
당연하지.	5
아니…	4
그러게 왜 티켓을 어떻게 구하는지도 모르는 주제에 큰소리부터 쳐 놨어? 하여튼간 오빠는 이래서 안돼.	3
다 어디 빽으로 되는거죠. 우리같은 평교사들이야 점수 쌓느라 빌빌대야 하지만.	0
아 이건 또 궁금한가보네~	3
아빠… 요즘 이런 거 다 필요 없어. 그냥 핸드폰으로 다 할 수 있어.	7
참… 면목이 없습니다. 그래도… 개인사는 개인사로 두고, 비즈니스는 비지니스로 할 수 없을까요?	4
"전 엄마랑 안 싸우는데요,	 동생이랑은 싸워요."	4
그러면 저랑 할머니랑 다녀올 테니까 할아버지는 집에서 금붕어 밥 잘~ 주고 계세요.	2
선생님 잘 지내셨어요?	7
봐야하는데 아직 너무 바빠서 못 봤어요. 진짜 이러면 안 되긴 하는데 나중에 확인하고 혹시 좀 특별한 거 있으면 말씀 드릴게요.	6
너는 옷이 그게 뭐냐?	3
어.. 오늘은 안 와도 되는데.	4
기회가 어딨어. 그냥 지르는 거지. 은퇴하고 내가 계속 건강할거라는 보장도 없고.	0
부모 마음대로 흘러가는 자식이 어디 있겠어요…	2
그러면 걔는 지옥갈 거 아니에요?	3
나 오늘 택배 올 거 있어서 안갔지.	1
그 병원에서 준 식단표가 있거든?	1
다 아는 방법이 있지.	1
그래? 그럼 다행인데.          결혼은 안 할 생각이니?	2
요즘 젊은 사람들은 전자 기기를 참 좋아해.	3
그치? 아… 인터넷 후기 보고 주문했더니, 향이 너무 아저씨 같아.	2
아. 먹어보긴 했는데.	2
지수 대학 동긴데. 지금 간호사 하고 있대.	4
여자가 뭐 병수발 드는 사람이야? 이상한 소릴하고 있어.  엄마… 요즘 어디가서 그런 소리 하면 무식하단 소리 들어.	3
언니가 편집 조금 도와주기는 했잖아.	4
너 요기서 안 먹어봤니. 초고추장이랑 해서 싸먹을 수 있게 주던데?	6
이번엔 방 청소를 좀 해야 할 거 같아.	7
참.. 어른들도 아이같다니까.	3
에이 계약서에 싸인 하고, 이미 돈 받았잖아.	6
그치? 내가 그럴 줄 알았어. 승지언니랑, 간다고 할 때 부터, 구란줄 알았어.	3
돈이 돼야 멋있지. 아 나는 언제 서울에서 집 사나. 서울에 집이 뭐야 전세라도 갈 수 있으면 좋겠다. 월세만 몇 년째야 지금. 돈 아까워 죽겠어.	4
모르겠어요.	4
현주야. 아빠 같은 아빠 없는 거 알지?	7
자네도 나이를 먹는구만. 어렸을 때부터 그렇게 눈이 좋더니만!	4
어딜 가?	1
에이, 예쁜 입으로 그런 소리 하면 써, 못 써.	4
네…?? 30인분 전부 다 취소하신다구요?	5
그러게 꼭 그 꼴이네.	2
이 동네에, 유명한 진상 있다고 하던데… 그거 당신이죠?	3
아우. 아무거나 입어. 아무거나 입어도 잘 생겼어.	0
아 그러세요? 이웃 주민이시네요?	5
매달 삼십 일에 꽂히는 오십 만원… 그건? 그게 진짜, 아들 된 도리 아니야?	3
약이야 약.	1
내가 지금 화 안 나게 생겼어요?	0
아니 무슨 문제를 풀 생각은 안하시고… 원래 이렇게 단서를 찾는게 제일 재밌는 파트예요. 집중 좀 하세요.	3
지은아. 너 고삼인데 성적이 이렇게 떨어져서 어떻게 하니.	5
가족에서 ‘가’를 빼야 진짜 의미래.	6
뭐가?	7
눈이 안뵈어.	0
어떻게 사람이 24시간 집중을 해 말이 돼? 다섯 바늘만 꿰매면 된다잖아.	4
아니 그냥. 궁금하잖아. 어떤 여자친구를 만나는 지.	2
또 뭐가 있는데?	7
 짜잔~ 중고차긴 하지만..	7
제가 답답해서 그래요. 답답해서. 어른들은 왜 애들 말을 듣지를 않아요?	0
일단…흠… 나는 2학년 때 편입을 했잖아.        솔직히 교육의 질이 다른지는 뭐가 그렇게 크게 다른지는 모르겠는데.	0
한식 말고는 다 별 볼일 없다는 소리야.	4
사람이 아니면 뭔데?	1
비씬걸로 사.	0
야, 미주야. 너 여기 좀 앉아 봐봐.	0
어휴, 등산이 뭐라고 참...	6
"내가 원래 좀 오바스러워.	 나도 알아."	3
요즘에는 부자와 가난한 사람을 그렇게 구분한다더라.	5
그래서 내가 그 친구한테 좀 투자를 하는게 어떨까 싶어서.	2
난 어느 방향으로든  좋아!	7
진짜? 야, 너 좀만 꾸미면 괜찮을 거 같은데.       이 언니가 스타일링 좀 해 줘? 말만 해.	7
그래... 집중력도 학습 능력이라더라…	3
 왜 그러냐! 왜 우리 누나 욕하냐!	3
아니, 위아래로 훑더니 피부과 안 다니세요? 이러는 거야.	6
할머니도 할머니 엄마 보고 싶을거 아냐..	4
뭐긴 뭐야. UFO는 실제로 존재한대.	3
알지. 아빠가 내일을 위해서 운동도 열심히 했다.	7
둘이 지금은 대화를 해?	3
 그랬더니...? 귀신이 있었어...?	5
나이 들어서 그래. 이제 운동 해야 돼.	1
전에 말했잖아. 사사건건 시비거는 선배 있다고.	4
아, 이거? 어. 이거 요새 고시생들이 많이 쓰는 펜이래. 대한민국에서 펜을 가장 많이 쓰고, 그만큼 까다로운게 고시생들이잖아? 그 사람들이 제일 많이 쓰는 펜이라길래, 내가 안 사 볼 수가 있어야지.	7
너 미쳤어? 학교에서 담배를 펴?	3
저도 아는데...  이번 달에 상황이 진짜 여유치가 않아서요.	4
뭐? 설마 똥차들한테서 클레임 들어왔니?	3
그래? 그럼 누나 이거만 다 보고 너 줄게.	5
아니다 그 전에 어디서 구했는지 써야 될 거 같아.	1
난리 났었겠네. 와 진짜 경수 대박이구나.	5
아버님께서 잘 해주셔야 합니다..	2
 아니요. 잊어버렸다.	2
음.. 당연히 쌩뚱맞죠. 한자예요. 여자 배우, 라는 뜻이고.. 주연상, 조연상. 나누는 것은.. 주인공이냐, 아니냐.. 이렇게 나누는 거죠.	1
몰라.	7
그러니까. 나 그래서 공기청정기 시켰잖아.	4
내가… 깨끗하게 남은 반찬은 버리지 말고, 가지~런히 다시 정리해서, 상에 또 내라고 했잖아.	3
그래. 어른들이 공부하라고 하는 거 그거 어른들 좋으라고 하는 말 아니야. 공부 잘 해서 좋은 대학 가면 너한테 좋은 거니까 하는 말이지. 알겠어?	1
너 이렇게 해서 대학 가겠어?	3
응.	7
내가 그렇게 단순한 이유로 땡땡이치는 것 같아?	4
와. 대단하십니다 진짜.	5
선처는 없다고…	2
그건 다 좋아서 그런거잖아요.	4
 에이, 뭐야. 호박? 호박은 별론데.	6
왜요? 부족하면 보태 주시게요?	6
 구 만원. 네. 맞네요. 그럼 잘 보살펴 주세요.	7
아….	6
암튼 사줄거지?	7
… 사실 맞아 나 너무 동생이 갖고 싶어	4
알았어. 그럼 내가 날씨도 더운데 무서운 얘기 해줄게 들어봐.	7
"아니야, 우빈아. 친구들도 그렇고, 선생님도 그렇고 	 우빈이를 얼마나 좋아하는데."	2
너 근데.. 부모님은 안 오셔? 아까 내가 선생님한테 너희 부모님 불러달라고 말씀 드렸는데..? 왜 안 오시지?	0
미안해… 아까 온 애들 보니까, 잘사는 집 애들 같던데… 너는 부모를 잘못 만나서…	4
야. 그 니 친구 중에 키 190넘고 주짓수하는 사람 누구야?	5
 알바생 새로 구하세요.	3
게임은 내일도 할 수 있잖아.	6
아니. 지금 말 하고 있는데?	3
그럼 이따가 12시 쯤 됐을 때 결정해도 되나? 지금 상태로는 안 먹어도 될 것 같은데,         점점 나아지고는 있어서.	7
뭐?	0
어, 은주야. 오랜만이다.	5
안돼. 오늘은 들어가야 돼.	6
응, 형님은 수술이 잘 되어서 마음 놓았어. 관리만 잘 해주면 끄덕없다네.	1
지은이 너 꽃가루라는 말 처음 들어봐?	5
그러게나 말이다.	4
못 바꾸죠. 그러니까. 선배. 화이팅!	3
너 지금 자진해서 말하면 선생님이 사정 봐줄 수도 있는데. 나중 가서 걸리면 그 땐 선생님도 어쩔 수가 없어. 알지?	0
사기나 당하지 마.	3
그러니까. 하긴 하루 종일 서서 일하면 힘들텐데, 돈도 안 받고 하는 일이면 너무 가혹하지.	3
응 괜찮아.. 웬일로 니가 걱정을 이렇게 다 해주네.	7
듣기로는 어머님도 회사에 다니신다고…?	2
그건 아마 체질이 바뀌었을 수도 있고.. 나이들면서 피부가 약해졌을 수도 있어,. 그런거 아닐까?	1
2학년 2반 김경주. 네시부터 여섯시. 맞지?	2
응. 정신 없긴 했는데 그래도 잘 마무리 됐어.	1
미안해, 지은아. 하지만 아저씨들이랑 선생님들이랑 같이 버스를 항상 잘 점검하고 있으니까 걱정 마.	4
어휴. 이제 재인이가 혼자도 아니고, 우리 도준이 빨래 하고,        요리도 하고 그러려면…. 그 정도는 할 수 있겠지요?	3
아, 나 요즘 막걸리 담그는 거, 배우러 다니잖아.	5
아… 네…. 죄송합니다.	2
어.	5
거짓말 하는 거야. 너 사회에서도 초범이랑 재범은 다르게 처벌하는 거 알아 몰라? 그게 다 괘씸죄가 적용되서 그런거라고. 내가 너 처음에는 봐줬지? 근데 이렇게 선생님 뒤통수 치고 어? 보란듯이 학교에서 담배 피고. 이런 거 나는 이제 못 봐줘. 당장 어머니한테 전화 드릴거야. 그렇게 알고 있어.	0
헐 얼른 봐야겠다.	5
걔가요...	4
아니, 뭘?	5
왜. 세준이가 뭐 실수했니?	4
미안해.	4
참.. 혹시 골다공증 때문인가?	1
응. 요즘 니가 말을 잘 안 듣는거 같아서, 친구들한테 상담을 하니까 이걸 써 보라고 하더라고.	7
네… 그럼 금액은… 어떻게 되나요…?	3
아이구 우리 회장님~ 니가 이렇게 강단있고, 강한 사람이라서 사람들이 다 너를 좋아하나보다.	7
하은아, 방금 선생님이 전화를 받았는데, 어머니께서 전화하셨어.	4
아무리 그래도 몸에서 바다 냄새 난다니까요 이제.	6
상한 거 먹으면 배탈난다니까.	6
어. 혼자 갔대.	1
귀신이 찾아오니까....!	7
내가 미리 학원에는 다 연락해놨고, 상담이랑 테스트만 받으면 되니까 걱정 마.	1
니 동생은 다 맛있다고 하잖아.	6
아니거든!	0
나는 시현이 네가 이렇게 한 순간에 나를 모른척 할 줄은 몰랐다.	4
너 내가 누군줄이나 알아?	6
아, 현세카드도 직장으로 괜찮은 곳이라고 들었는데. 그쪽은 경력직 잘 안 뽑나요?	5
그쵸. 저도 그 때는 그렇게 생각했는데. 요즘엔 아닌 것 같아요.	2
 하..	0
당연하지. 건강하기만 하면 돼.	7
형… 나 아래 까지만 데려다 주면 안돼?	4
아니… 그런게 아니라.	3
핸드폰? 벌써 그런 걸 가져도 돼?	5
응. 이모가 영화표 사줄게. 희동이랑 보러 갔다와.	1
마트에서 사오면 되잖아요.	6
중학생 되면 형이 철봉 하는 법 알려줄게.	1
 내가 타투하고 싶다고 그랬거든.	6
"아이 참. 현금은 좀 정 없으니까 상품권으로 할란다요.	 형수님 어디 백화점으로 자주 가시나?"	5
진짜 좋았겠다. 나는 여행 진짜 너무 가고 싶은데,        우리 아빠는 여행 별로 안 좋아하셔.        마지막으로 갔던게 엄마랑 갔던 담양 여행이었는데.        그 때 대나무 숲이 진짜 너무 예뻤어.	4
너무 무섭잖아. 나 혼자 집에 있었고, 드나든 사람도 없었는데 인기척이 난다는 게?	2
에이씨. 	4
그래, 걱정하지 말고 편하게 말해 봐.	5
혹시 무슨 문제가 있나요?	2
어디 보자… 글쎄. 음.. 금요일 오후에 온다고 하더라. 금요일이면 얼마 안 남았잖니?	1
엄마한테 한번 가서 물어봐라. 너가 지금 유난 떠는지 안 떠는지.	1
아 그런 일 해서 빚을 언제 다 갚아.	0
아, 그럼 거기로 다시 돌아가야 돼요. 거기로 가서 지금 왼쪽으로 왔잖아요. 오른쪽으로 가셔야돼요.	1
근데 그럼 한 잔 시키고 죽치고 있는 거 아니야? 가게 회전이 되나?	6
근데 요즘 PX에 이것저것 많이 들어오지 않냐?	7
진짜 아무 생각 안 하고 있었는데?	7
아직 한창 팔팔할 때네.	0
"말 하긴 했는데요, 	진짜 억울한데, 선생님이 저 안 믿어주는 것 같아요."	6
아니, 핸드폰 붙들고 있으면서 뭐가 피곤해!튼튼한 다리로 좀 서서 가.	0
"	다시 할게. 다시 해서 먹자. 내가 미안해."	7
나한테는 그냥 매일이 악몽이야!	3
사범님이 고민 좀 해볼게.	4
"왜 물어보기는. 미성년자가 불법적인 일을 했으니까 	처벌을 받아야지!"	0
"알지. 그것도 내가 사줬잖아. 	근데 벌써 7년이나 됐고, 	너는 디자인 전공하는 애가 컴퓨터 좋은 거 써야지."	2
그래. 너가 효자다 효자. 그래서 회사는 다닐 만 해?	7
응. 공포 영화를 보면 좀 시원해지잖아.	1
조금만 기다려봐. 지금 타이밍 보고 있어.	6
그래도 요즘에는 날씨가 좋아서 다행이지.         겨울에 추웠어서, 오돌오돌 떨면서 밥 먹었잖아.	6
인상도 엄청 좋으셨잖아요. 그런 분이 이렇게 가시다니. 기분이 이상해요.	4
아, 흰색 자동차인 건 우리도 알아서요, 뭐 다른 거 없어요?	6
네… 많이 쓰는 말이라서.. 써봤는데… 죄송합니다…	2
"아~ 그 얘기? 너희 엄마가 어렸을 때 엄청 영특했지. 	학교에서 상도 엄청 많이 받고, 맨날 반장도 하고 그랬어. 	공부도 엄청 잘 해서 성적도 엄청 좋았어."	7
"그냥. 너는 니 할 일 하고, 나는 내 할 일하고, 	이러는 게 참 좋아서. 같이 또 따로, 뭐 그런 느낌?"	7
아니, 밥은 안 먹고, 미팅이 있어서.	7
그걸 왜 지금 말씀하세요?	2
이번 추석에 해외여행 가기로 했잖아요.	2
저기.. 제가 핸드폰이 없어서	4
네. 언제부터 운전하셨어요?	1
엄마 나 오늘 학원 안 가면 안 돼?	2
난 너무 마른 건 싫어.	6
"죄송합니다.. 졸업할 때까지만 부탁드릴게요.	 지금 방을 얻으면 학원비를 낼 수가 없어서 그래요."	4
언니 그 때 소 팔았지?	6
네?	2
줍고 가. 니 입에다가 쳐 넣기 전에.	3
에이… 말도 안 돼요.	5
"어휴 됐어요. 사람이 자기 분수에 맞게 살아야지. 	저 아직 대리에요."	6
안녕하세요.	7
아 엄마가 뭘 문제집을 봐. 보면 뭘 알긴 알아?	6
진짜 혼자 있을 수 있지?	2
내 생일은... 8월 9일이야!	7
얼씨구. 형한테 무슨 말버릇이야?	0
아… 턱까지 욱신욱신 한 거 보니까, 사랑니 난 것 같애.	6
근데 제가 너무 화장실이 급해서 들어온건데요	4
에휴… 담배 냄새가 그렇게 나면서… 할머니가 아빠한테 한 번 얘기해볼까?	3
손??	5
무슨… 일이 라도.	2
자기 음식 너무 맛있어서, 식당 차려도 될 것 같다니까.	7
먹통이 됐는데 그럼 어떻게 해. 미리 저장을 잘 했어야지.	6
여자야…	2
왜요?	6
아…	6
문제는 하나는 전 남자친구가 자주 가던 카페고… 하나는 전에 친하던 친구가 자주 가던 카페야…	4
진짜? 이번 깍두기도 잘 됐어?	7
아우 짜증나. 그래서요? 지금 저보고 치과를 또 오라는 거예요?	3
이제와서 어쩌겠어.. 그냥 그렇게 된 것을…	1
그럴 거 없어. 친구가 너한테 되게 잘 보이고 싶었나봐. 나쁘게 생각하지말고 이해해줘. 분명 나중에 이해해줘서 고맙다는 생각을 할 거야.	7
알았어… 미안.	4
나이가 오십이 넘었는데 새로운 게 뭐 좋냐. 익숙한 게 좋은거지.          내가 좋다는데, 왜 니가 난리야.	0
그래. 그래. 잘 될 거야! 힘내야지.	2
몰라 걱정돼 죽겠다. 벌써 오늘부터 잠이 안올 것 같아.	6
몰라. 할머니는 스무 살 때 엄청 어른스러웠나봐?	3
주산이 뭐야?	5
 그럼...	2
비아냥거리지 마. 나도 나름대로 엄청 열심히 하고 있거든? 그리고 3월 모의고사 때보다 등급도 훨씬 많이 올랐단 말이야.	0
기존 화장실이 불편한 사람들을 위한 배려야. 업-투-데이트 좀 해. 기자라는 사람이 너무 모른다.	5
과연 엄마도 그렇게 생각할까?	5
죄질이 나쁘다는 뜻이에요.	0
어. 그. 왜 여름에 한국 극장가에 걸리는 공포영화들은 다들 짜기라도 하듯, 소재가 다 비슷비슷 하잖아. 맨날 여고생들만 나오고.	3
나는…. 엄마를 닮은 거 같아. 엄마가 워낙 똑똑하잖아.	1
" 	니네 엄마 아래서 자랐으면 그럴만도 하네."	6
말이 그렇다는 거지. 좀 고운 이야기를 써. 고운 이야기. 사람은, 다~ 길 따라 가는 거야.	0
네?	5
옛날? 어릴 때? 어디 나왔었는데?	5
아아아아아 시켜줘 시켜줘.	0
너가 공부를 잘 해서. 북어가 너한테 함부로 못하는 거야.	3
 수지야… 살려줘…	2
이렇게 맨날 피곤하다는 소리 할거면 운동 뭐하러 하냐? 어?	0
허밍?	3
전학?? 싫어! 전학가면 미연이랑 못 놀잖아. 이사 왜 가는데?	6
그게 어려운 일이긴 하지. 그래서 다들 엄청 열심히 공부하고.. 꾸준히 공부하고.. 그러지.	4
거짓말까지 하는 거야?	0
아… 분명 시럽 빼달라고 하셨거든요…	2
야금야금 까먹으면 안 돼? 자식들 때문에 그래?	1
저…. 혹시 할아버지. 돈 좀 빌려주실 수 있어요?	2
수술 끝나고 회복실에 있는데.. 그 때서야 이게  암이 아니라고 하는거지..	2
 어디 보자… 뭐 먹을래?	1
에이, 그래도 가격이 싸잖아. 가까워서 그런지 거기만큼 비행기가 싸게 나오는 데가 없던데.	1
나이 차이도 별로 안나면서... 나 삼촌이랑 같은 나이 친한 형들도 많아요.	3
애도 아닌데 삐진거 같은데 지금?	3
참, 내가 이래 봬도 왕년에 여자들한테 인기가 많았던 거 알지?	0
그렇지! 요즘은 30대가 옛날 20대래	7
그냥, 평소에는 동아리방에서 책이나 읽고, 공부하고.       근데 방학 때, 우리 같이, 캠프 갈거거든.	7
내가 운이 좋은거여?	5
제가… 직업이 좀 불안정하죠? 근데 수입은 안정적이고, 아! 또 적금도 여러 개 붓고 있구요...	2
수험생인 건 이래서 안 좋은 것 같아요. 나 말고 다른 사람들이 전부 다 내 공부를 걱정한다니까.	0
"그거야, 저 친구 사정이지.	 니가 왜 또 오지랖이야."	6
왜긴. 그냥 안 맞으니까 헤어진거지.	4
아니, 형이.. 아니 오빠가 성빈 선배라고 미리 말을 하지.	2
나도 화장품 가지고 싶단 말이야.	4
갑자기요? 집에서 잘 돌볼 수 있는 사람이 아무도 없는데요.	5
엄마는 아빠가 왜 좋았어?	1
에이...아빠 서운해?	4
 안 죽였어요… 안 죽이려고 했는데…	4
나? 나야 뭐 suv 몰지.	7
드라마 티비로 보면 되지. 왜 그렇게 작은 화면으로 봐?	6
근처에 대학이 많잖아. 여기도 바로 계약 안 하면 언제 나갈지 몰라.	7
버릇이 들어서, 이제는 커피가 없으면 입이 허전해.	1
그럴까? 같이 주사 맞아야겠다	5
아니구요. 제가 좋아하는 밴드가 있는데, 최근에 일본에서 공연을 자주해서. 그거 보러 가는 거예요.	6
유치원 선생님이 말해줬는데, 이사가서 새로운 집이 생겼을 때, 친구들이 거기에 놀러가는 걸 집들이라고 한대.	5
그래?	5
"와.. 오빠 나이 나온다.	 어떻게 예시를 들어도 그런 걸 드냐.	 나 할머니랑 대화하는 줄."	6
아니 내가 보니까 처음엔 제자리에 있던 꽃이 점점 처지더라니까.	5
아 죄송해요. 제가 요새 다이어트 때문에 민감해서.	5
애들 빈자리가 크기는 하죠?	4
네.	1
아… 선생님 진심이세요?	3
싫어.	0
낳아준 애비가 있을 거 아니야!?	2
계약서 대로 안한 니 잘못이지! 이게 내 잘못이냐?	1
그렇다고, 당근만 모아서 하수구에 버리면 어떡하냐?	3
아니요. 오늘 엄마 친구네 온다고 멀리 왔어요. 엄마랑 버스 타고 왔는데… 왜요?	1
그냥… 이렇게 열심히 공부 하고 좋은 중학교 가고 어른돼서 일해봤자, 다 무슨 의미인가 싶어.	4
아 은후네 강아지 키운대.	5
내가 우리 가족 보호잔데… 더 열심히 할 거야.	7
그러게. 그래도 언니는 회사 생활 잘 하는 거 같어.	7
덕분에 오랜만에 치킨 먹었네요.	7
 속이 후련하다 속이 후련해.      저승에서 다신 보지 맙시다!!! 우리 다신 만나지 맙시다!	4
이모, 엄마가 이모한테 돈 받으라고 했어.	1
죄송해요 아빠… 제가 일부러 그런 건 아닌데요..	2
아휴… 내가 다 망친 것 같아. 내 남친이랑 엄마랑은 사이 좋았었는데, 이제 셋이서 만날 수도 없게 됐어.	4
돈 나올 구멍이 없는데 자꾸 이러시면 어쩌라고요...	4
어! 그거 입음 좀 엄마 시금치같아 보인단 말이야.	6
요 며칠 할머니네서 지내는데 너무 행복했어.	7
"여기, 밤 9시만 되면 흐느끼는 소리 들린다고 했단 말이야.	 그거 찍고 가야지."	6
나 먹는 거 야금야금 줬더니, 입맛이 어른 입맛 됐어.	1
정 보좌관한테 연락해서 간담회 끝나면 내가 의원님 찾아뵌다고 연락해놔.            보도자료 잘 준비해놓고.	6
 효진아 너 담배 폈니?	5
너 내가 누군지 몰라?	5
선생님... 저희 아빠랑도 통화하셨다면서요.	3
저희 아내는 시골은 절대 가기 싫다던데.	6
으이그. 그러니까, 이렇게 중요한 걸 빼먹니.	6
나도 젊어.	0
오늘은 세 분 만나실 거에요. A 호텔에서 두 분, B 호텔에서 한 분이요.	1
뭐 한다고 장난을 쳐서 다쳤어!	3
콜.	7
여기서?	5
그럼 뭔데. 설마 너 돈 뜯겼니? 그래서 지금 돈이 하나도 없다는 거야?	0
강남에서 해?	7
우와 궁금하다. 아빠도 보여줘.	5
아무것도 안했는데요?	5
따지고 보면 예능이 다 그런거잖아. 남들이 뭐 먹고 놀러가는 거 구경하는거지.	6
왜요?	2
아유. 짠냄새야. 이제 그만 좀 해.	3
그건 학생 사정이죠!	3
그래그래 그게 좋겠다. 김밥 같은거 시켜서 집어먹을게.	7
"당연히 알지. 	엄마 거짓말 못 하잖아. 	나도 한 번 놀려봤어."	3
그 많은 사람들한테 장어를 사준다고?  적어도 100만 원은 넘게 나올 거 아니야.	5
부모님 모시고 와라. 오셔서 무슨 일이 벌어졌는지 당연히 아셔야 하는 일이야.	0
어디다가 오천만원을 쓴거야? 나는 이해가 안가서 그래.	3
닭이 드시고 싶은거면 백숙이나 삼계탕 해드릴까요?	5
아, 그거… 내가 입었어. 저기 어디 있을 걸.	5
그거야 나잇대가 그러니까 그렇겠지	3
네. 교실 칠판에다가 이름 적어 뒀어요.	1
혼술 좀 하지마라. 알콜중독 지름길이 혼술이야.	0
그래. 예물 예단은 잘 준비했지?	6
아 근데… 제가 손목터널 증후군이 좀 있고 해서요…	2
걔는 동아리 같은 거 안 한대. 혼자 노는게 좋대.	4
 취한 건 아니지?	7
나는 배불러. 아까 너랑 같이 점심 먹었잖아.	6
1504호인데요!	6
삼촌! 삼촌은 왜 대학 갔어?	7
 귀한 사람이 왔네?	7
물리긴 했는데. 심한 정도는 아니야. 피만 조금 났지 뭐.	2
아니… 얼굴에 뾰루지가 나서요.	4
알았어. 근데, 걔는 몇 살이야?	5
술집도 요즘 너무 어려워. 비슷비슷한 가게가 얼마나 많은데.	0
내가 한 번 얘기해볼까?	2
할부 원금… 음, 알았어. 기다려봐.	2
잘 안하긴 하더라고요. 그럼 선물을 뭘 해드려야 하나...	1
나 맨날 톡하는 애.	7
에휴. 가는 거에 순서가 없어. 그냥 명대로 가는 거지.	4
"어머니 살아 계실 때까지 제가 버텨 볼게요.	 그러니까 어머니 오래 오래 사세요. 아들 자식 위해서라도."	7
너는 꼭 어디서 잃어버리고 나한테 와서 찾더라	0
너 때문에 내가 요새 사우나도 새벽에 가 잖아!	0
나도 그런 줄 알았거든? 근데, 걔 아무한테도 소문 안 내고 작년에 중국 기획사 들어가서, 다음 달에 거기에서 데뷔한대. 개소름.	3
"야 나이 30 중반 넘어서, 	모아둔 돈도 없고, 빚이 이렇게 많은데 	뭘 잘하고 있는건데?"	6
누구 맘대로 별거 아니라는 거야?	0
그래도! 같이 걷는건 또 다르지.	7
엄마가 너 믿어도 될까?	2
그러니까요. 왜 그런 꿈을 꿨을까요?	6
손 좀 눌러줄까?	1
 자 여기.	7
여자들한테는 세상이 아주 위험하고, 흉흉하다고.	2
꾀부리지 말고 얼른 학원 가. 아빠 괜찮으니까.	3
 불덩이네.	5
종이 같은 게 젖을 일은 없다는 거죠? 물세탁이 아니면?	5
아이고. 이것참.	4
 응. 자다 깨 가지고, 머리 다 까치집해서.	7
초코 케잌 먹었으면 됐지 치즈 케잌까지 먹을려고 해?	6
나랑은 말 많이 하는데?	7
얼른 가져와!	0
아, 참... 지난 주에 휴강을 했었죠.. 내가 요즘 나이가 들어 그런지 깜박깜박 하네.	4
교수님, 저 그 성적 받으면 안 돼요.	4
 나? 포스터 만들어.	7
아빠나 필요한 것만 사. 맨날 골프채 사면서. 치지도 않을 거 뭐 하러 자꾸 사.	3
엄마 말 대로 그냥 적당한 사람 만나서 결혼할 걸 그랬나봐.	1
꿔버로우? 그게 뭐야?	5
내가 사과 안 했어요?	0
그럼 닦고 줘야지.	3
내가 나이 먹었다고 엄마를 남처럼 대했으면 좋겠어? 딸은 영원한 딸이지.	4
"아마도 그럴걸? 	 재민이는 공연에 집중하느라, 주변 상황은 잘 보기 힘드니까,	 내가 잘 봐줘야지."	7
"이거 이거 영 천치구만.	 사람이 괜찮은 거랑, 사람을 좋아하는 거랑은	 아~무 상관 없지."	6
안 그래도 기숙사 떨어져서 심란한데 왜 자꾸 깐족거리냐.	0
근데 형 손이 엄청 부드럽다… 꼭 여자애 손같아.	1
그렇지? 그놈 시키 얼굴 한번 봐야겠는데?	7
 입 닥치라니까?	3
"누나만 믿으라니까!	 이건 추측이 아니고, 수많은 선례들로부터 나온 통계를 기반으로 한, 예측 가능성이 아주 높은 미래야."	7
 선생님, 왜 정자로 오라 하신 거에요?	7
뭐가 감사해.. 어른들이 더 잘해야지..	7
하… 운명도 참 얄궂다.	4
"뭘 그렇게 일을 또 크게 벌려.	 그냥 책이나 읽으면 되지."	6
저 쉽게 안나갑니다.	0
친구들하고 술 마셨어요.	6
하자? 무슨 하자가 있어?	5
아빠가 여름에 쓰려고 휴가 모아놨으니까 걱정 마.	7
그래도 엄마가 대학은 나와야 된다고 하셔서.	4
근데 걔가 저를 좋아해요.	6
네?	2
엄마, 저번에 콩나물 많이 먹어야 잭과 콩나무처럼 쑥쑥 큰다더니  아무 일도 없었잖아. 거짓말쟁이!	0
옛날에는 좋은 곡이 많았지요.	1
아버지가 너 있는 광주로 가시는 건?	6
걱정하지마… 누나 싸움 잘해.	1
다니면 되잖아.	0
콩국수 해먹었지.	3
그래. 내가 그래서 꼴등은 아니고, 뒤에서 2등을 유지하는 거잖냐.	7
깜박 잠들었는데 코를 골아? 너 코 골아서 깨운거야…	3
그냥... 몰라 희순이 미워.	3
너는 왜 피시방 안갔어?	1
어. 우빈아.  이거.	7
먹방? 근데 사람들 너무 많이 하지 않아?	2
뭐가 기분 나빠.	6
정훈이한테도 사실대로 말해야지. 그래야 지 아빠 편을 안 들지.	4
 이게 무슨 냄새야? 자네 향수라도 뿌렸어?	1
교수님. 도장 하나만 찍어주시면..	2
아휴, 우리나라, 성적에 목숨 거는 거 알아 줘야해. 진짜 애들 불쌍하다니까?	3
그렇게 늦게 자면 어떡해.	6
미세먼지 때문에 너무 힘들어요	6
 좋긴 뭐가 좋아. 다 낡아서 쓰러지기 직전이지.	7
 아까 한 얘기 그대로 한 번 해보세요.제가 다 찍고 있거든요? 똑같이 해보시라구요!	0
아니. 그냥 외상으로 달아줘.	6
쩐다. 나는 객관식 세 문제는 찍은 거 같은데.	6
으아~ 안먹히네. 독한 것.	4
응.. 근데 당신이 운동을 안 좋아해서 많이 못했지 결혼하고 나서는.	1
지훈아 이번 크리스마스 선물로 뭐 갖고 싶어? 아빠가 미리 산타할아버지한테 얘기해놓을게.	7
아빠 나 들어오는 길에 교통사고 난거 봤어.	2
발라.	6
아저씨. 저, 앞 집 사람이에요. 눈 좀 뜨고 보세요.	0
그래~ 아팠구나. 근데 너 지난주에도 아프다고 하지 않았냐?	3
"엄마가 보는 드라마에서 봤어. 	그래서 혹시 엄마 아빠 사랑이 변했을까봐 물어봤어."	4
생각해봐바. 무서운 뒷산에 올라갈 때 얼마나 무섭겠어. 그러면 서로 손도 잡고 얼싸안기도 하고 그렇게 된다니까?	7
" 어. 아빠..	 아직 안 나가셨어요? 늦으신 거 아니에요?"	5
공부를 공부방에서 해야지 여기가 시끄러워서 공부가 돼?	6
"니가 알아서 잘 챙기긴 개뿔. 	제수씨가 안 챙겨주면 아무것도 안하지?  너 무슨 운동 하는 것도 없지?"	3
나는 냄새는 모르겠는데, 이걸로 샤워하니까 확실히 피부가 덜 건조해진 거 같아. 촉촉해.	1
학교 다니기 진짜 힘들겠다.	4
야 요즘 취업하기가 하늘에 별따기래잖냐.        너는 완전 빨리 한 편이지.	7
우리 때보다 더 살기 힘든 거 같애.	3
혹시 무슨 일인지 물어봐도 돼?	5
네? 뭐가 아니라는 말씀이시죠?	5
음... 일단은 이번에 할머니가 시켜준 거 다 먹고. 그 다음에 골라볼게.	1
당연하지. 그 사람들은, 딱 인상만 봐도 어떤 사람인지 알거야.        너가 조금 실수해도, 실수인 걸 알거라고.	6
그래요? 그렇다면 너무 다행이네요. 저 정말 걱정 많이 하고 있거든요.	4
네, 일단 씨씨티비를 확인을 해 봤는데.	1
앞으로 잉어찜 질리게 먹게 될거다.	6
그래? 쉬엄쉬엄하면 별 거 아닐 거라고 생각했는데… 힘들구나.	1
말 꼬투리 잡게 만드는게 누군데 그래요? 애초에 사과하고, 보상하고. 그러면 되는건데 왜 이렇게 나오세요?	0
할아버지 이름도 한자에요?	5
뭐.	2
정말… 말해도 괜찮을까요?	2
이러고 핸드폰 하는 시간은 안 아깝냐? 쇼하지 말고 빨리이.	3
그럴 수도 있지.	4
서른 셋이면 나보다 이십 살이나 많은 건데, 늙은 거지.	6
아니 돈이 적어? 백 만원이야 백 만원. 와… 진짜 그 아저씨 웃긴다. 사람을 얼마나 우습게 보는 거야?	3
이재용. 왜, 애들이 맨날 재드래곤이라고 부르던 걔 있잖아.	1
진짜 웃기고 있네… 야, 정신차려! 	3
겉만 봐서는 모르지.       근데, 그 라이벌이라는 애랑은, 친구였어?	7
아니. 너무 부담스럽잖아.	6
새 엄마냐?	3
"선생님도 삼촌보다 더 좋은 분 만나야지...	  시온아, 삼촌 나갔다 올게. 엄마한테 삼촌 오늘 좀 늦는다고 전해줘."	4
시무룩?	4
아니~ 그것도 집에서 논 거잖아. 아! 도움이 안 된다 할머니!  	0
누나가 곱게 붙여 주겠어?	3
그래. 내가 여름엔 아이스크림 퍼 먹고, 겨울엔 단팥죽 퍼 먹는 재미로 살았는데...	1
저인가 했는데… 실례가 안된다면… 발을 좀 저랑 멀찍이 놔 주실 수 있을까요?	2
물놀이? 좋아! 계곡 가는거야?	7
무슨 말이야 그게. 이삼 년이나?	5
그래? 방학이야?	5
그럼 닭다리 하나 두고 매일 둘이 싸우는 거야?	5
고맙긴. 풋풋하네. 자 그럼 고민 해결됐으니까 수업 할까?	7
진짜 왔네… 뭐 물어볼까?	1
지금 몇 살인데?	5
칠천 이백 원? 고마워 할머니.	5
나쁜 짓 하면 다 그대로 돌아오는거야	6
돌잡이는 잘 했어?	1
음... 마르게리따!	1
네. 반가워요.	7
아니더라도, 믿어서 나쁠 건 없잖아?	4
음 이번에 정기 검진 했겠네? 공단 다녀왔지?	2
민철이가 새 아버지가 있었거든.	4
오늘 미희씨가 아파서 승윤씨한테 마감 부탁한다고 했는데, 얘기 못 들었어요?	0
들었잖아요..	0
살처분 말고, 다른 해결책은 없는 겁니까?	3
저도… 책 연체 했다고 이렇게까지 될 줄 몰랐거든요?	0
 그래, 어쩐 일로 왔어?	6
그냥 영감 쪽 속성 아무거나 찍음 돼.	6
아니, 내가 지난 번에 자꾸 돈이 빈다고 했잖아.	0
내가 무슨 눈치를 줬다고 그래, 너?	0
네. 신고는 아무도 안 한 것 같길래 제가 경찰이랑 119에 신고한 거예요. 119에 먼저 하고 경찰에 나중에 하고…	1
그 영화를 보고 나서 삼일 내내 울었어. 그리고 나도 그런 연기를 하는 배우가 되고 싶어졌어.	4
혜선이가 왜?	5
왜?	2
무슨 운동화길래, 그렇게 갖고 싶은 거니?	5
그건 그렇지. 진짜 특이한 사람 많더라.	7
